cell	celltype
CAACGATTCGGTCTAA_3	DC2
GTGAGCCAGCTCGTGC_3	Plasmablast
TCAGCCTTCGAGCACC_3	HSC
AAGTACCTCAAGCGTT_3	Plasmablast
AGACAAACACTAACCA_3	MZ B
ATCCCTGCATCGTGGC_3	Plasmablast
CCTACGTAGCATCTTG_3	Plasmablast
TCCCAGTCATCGGCCA_3	Plasmablast
AGCTCAAAGCTATCTG_3	Plasmablast
TGGGAGATCCTTCGAC_3	HSC
CTTGATTCAGCGTAGA_3	Plasmablast
CGGACACGTCCACACG_3	Plasmablast
TCCAGAATCCGTCCTA_3	HSC
CTAAGTGGTTTACGTG_3	Plasmablast
TGCACGGCATGGCACC_3	Plasmablast
GAGGCCTGTGCACATT_3	EC
ATTCTACGTACAACGG_3	Plasmablast
GAGTCATGTCCAGCGT_3	Plasmablast
CGAGGCTGTTCTTAGG_3	Plasmablast
CACAACACACTATCGA_3	Follicular B
GACAGCCGTAGGTCAG_3	Plasma cell
CTGAATGGTGAGGCAT_3	Mac
CTCCATGTCCACACAA_3	Plasmablast
ACCTGTCTCAAGAGTA_3	Mac
AGATCCAGTAGATTAG_3	EC
AGCTTCCCAGCCGTCA_3	Plasma cell
CAGCACGCACACGTGC_3	HSC
ATACCGACACGTACTA_3	Plasmablast
CAGCACGAGCGGATCA_3	Plasmablast
AATTCCTCAGAACATA_3	ILC
TACCCACCAAAGCGTG_3	EC
GTGTAACTCTTGCAAG_3	Plasmablast
CCACGTTCAGGCACAA_3	Plasmablast
TAACTTCCAACGGCTC_3	Plasmablast
CATCGCTGTGCTTCAA_3	DC1
ACCTACCCACTACCGG_3	Plasmablast
CCCTAACTCAGCCTCT_3	Plasmablast
TAAGCACCAAATTGCC_3	Monocyte
AGAACCTGTGGACAGT_3	Plasma cell
TTTACGTCAGACTCTA_3	Monocyte
GCGTTTCCAAGCGATG_3	Plasma cell
TTCGCTGAGGTCGACA_3	Plasma cell
CCCTCAAGTGGAACCA_3	CD4+ T
AGTCAACTCCTAAACG_3	Plasmablast
ATCAGGTCACCATATG_3	Plasma cell
GACTCAACAGAAACCG_3	HSC
TCATTCATCAGATGCT_3	DC2
TCGACCTTCTCAATCT_3	MZ B
CGGAGAAGTACGATTC_3	Plasmablast
CATCCCACATCCGAAT_3	ILC
GTCGCGATCTTGGAAC_3	Plasmablast
AGTGATCGTGTCTTCC_3	HSC
CAATACGCAACTCGTA_3	DC2
TTCTAGTTCTTCTGGC_3	Monocyte
AGTTCCCCACAGTGAG_3	HSC
CCACGAGCAAACGGCA_3	Plasmablast
AGGATAAGTCGCAGTC_3	MZ B
AAGGTAAGTACGCTTA_3	Plasmablast
ACACGCGGTTAAGACA_3	HSC
TACGGTAAGACGACTG_3	DC2
GGTGAAGTCGACGTCG_3	Plasmablast
TACCGAATCCGGCAGT_3	Monocyte
AGAAGCGCACTGCACG_3	MZ B
ATGAGTCAGGCTCCCA_3	EC
CGCAGGTAGACCAAGC_3	Monocyte
AACAAGAAGAATTGTG_3	Plasmablast
AATGGAATCCTCAGAA_3	Plasma cell
AGTCAACCAAAGGTTA_3	HSC
CACCAAAGTGTTTGCA_3	ILC
ATACCTTGTGGCTTAT_3	Plasmablast
TCTGCCAGTAATTAGG_3	HSC
GGTTAACTCACCGCTT_3	MZ B
TGGTTAGAGATGCTGG_3	Plasma cell
CGTTAGAGTTCAATCG_3	Plasmablast
CATAAGCCATGAGTAA_3	Plasma cell
TACGGTACAGTATTCG_3	Plasma cell
AAGTTCGTCGTGGAAG_3	Plasmablast
CGCAGGTTCCTGTTAT_3	HSC
ACTCCCACAGTAGGAC_3	DC2
ATCCACCTCCGCGGAT_3	Plasmablast
CACTTCGGTGTTACAC_3	Monocyte
CACCGTTCATCAGCAT_3	Plasma cell
CAACGATTCTCGAACA_3	DC1
GTATTTCAGTTCCATG_3	Monocyte
GATGCTAAGTCTGTAC_3	Plasmablast
ATCGCCTAGATGTAGT_3	Plasmablast
AGCGCCAGTGTCTTGA_3	Monocyte
AGTTCGAGTTCGTTCC_3	HSC
AACACACCACACCGCA_3	Plasma cell
ACGTAGTCAGGCAATG_3	Plasma cell
AAGTACCGTTCCGGTG_3	DC1
GAAGCCCTCTACAGGT_3	Plasma cell
AAGCATCCACAAGCCC_3	Plasma cell
AGGAAATGTTCAGGTT_3	MZ B
ACTGTGATCCATTTAC_3	Plasma cell
ACAAAGAGTCCATCTC_3	Plasma cell
AGACCCGTCAAGTGTC_3	Plasma cell
AGGGAGTAGAGTTGCG_3	Monocyte
GATCATGAGCATTTGC_3	Monocyte
GTCTAGAAGTTCAACC_3	MZ B
TCATGAGCACTCAGAT_3	Monocyte
CAAGAGGAGTAACGAT_3	Monocyte
ACAAGCTTCCAGCTCT_3	DC2
CATCGCTGTGGTCCCA_3	Monocyte
TATATCCTCTCCGTGT_3	EC
GAACGTTCAGGTATGG_3	HSC
AACAACCAGAAGGATG_3	DC2
ATCACTTGTGCCTGAC_3	DC2
GGGACTCCAGTCAGCC_3	DC2
AGAACAACAAATCGGG_3	Plasmablast
AAGTACCCAGAACATA_3	DC2
GATGATCCAAAGGGCT_3	Plasmablast
TGACAGTAGCACCGTC_3	HSC
AGAGAATCAGACAAAT_3	Monocyte
TCACACCAGTATGAAC_3	DC2
CTGCCATGTAGTCGGA_3	Plasma cell
ATCTCTAAGACTCTAC_3	DC2
GAGATGGCACAGCGCT_3	HSC
CATGCGGGTGGGCTTC_3	MZ B
CAACCTCAGTAACCTC_3	Monocyte
GGTAATCTCAACCTCC_3	DC2
ATTTCTGTCTAGAGCT_3	Plasmablast
TGCAGATGTATTGCCA_3	HSC
TGATGCAAGCTAGAGC_3	HSC
AGACCATTCATTGCGA_3	DC2
CATCGGGAGACAAGCC_3	HSC
CTGTACCGTAATGCTC_3	Plasma cell
GTAGGTTCATCGCTGG_3	DC2
CTACCTGTCGGTTCAA_3	Plasma cell
TTCATTGCATTAAGCC_3	DC2
TGACAGTGTCGTCTCT_3	DC2
GCCAGGTGTCATTCCC_3	Follicular B
ATCGGATGTCTAACTG_3	Monocyte
GAAGCGATCCCGTAAA_3	Plasma cell
ATTACCTTCTCAATCT_3	MZ B
GTGACGCAGCAGTACG_3	Plasma cell
ATCCCTGCACCAGGTC_3	HSC
TGTTGAGGTACCAATC_3	MZ B
TCTCAGCAGTGCCGAA_3	ILC
ACAAAGACAGCAGTGA_3	Monocyte
AGCGCCATCCAACTGA_3	HSC
CAGTGCGCATGACGGA_3	MZ B
TCACGCTTCAGAATAG_3	Monocyte
TCACGCTTCCTCAGGG_3	Monocyte
ACCCAAACAGTGCGCT_3	HSC
AGGCATTCAACCGCTG_3	Mac
GTGAGTTAGAAGCGGG_3	Monocyte
CAACAGTAGGAATGTT_3	DC2
AGGACTTCAACTGGTT_3	Plasma cell
TCAGTGAGTCTCCTGT_3	Plasma cell
CCTAACCGTCGTGATT_3	Monocyte
CCTAACCCATTGGCAT_3	DC2
ATACTTCCAGTCACGC_3	Monocyte
AGAACCTGTATGGAAT_3	Monocyte
ATTGTTCAGATTGGGC_3	Monocyte
AAGACTCGTCGACTGC_3	MZ B
AGCTTCCAGGTTACAA_3	MZ B
AAGACAATCGAGCCAC_3	MZ B
TCACGCTGTTGTAAAG_3	DC2
AACAAGATCACCCTTG_3	Monocyte
GACCTTCCACGAGGAT_3	Monocyte
TGATGCATCACTAGCA_3	DC2
TCTGGCTGTTATCTGG_3	Plasma cell
CTCAGGGTCGAACGCC_3	Monocyte
ATCCATTAGGTAAACT_3	Monocyte
CTGTACCCACGTCGGT_3	ILC
ACGATCATCTCCAATT_3	DC2
GACGCTGAGGTGTGAC_3	Fibroblast
TCAATTCAGGCACCAA_3	Monocyte
TGTAAGCCAGTAGTTC_3	DC2
GGAGATGCATCAGTGT_3	DC2
CACCAAATCCTCTAAT_3	DC2
GGTTGTAGTCAGTCCG_3	Plasmablast
CACTGTCTCCGTAGGC_3	EC
GGTGATTCAATACCTG_3	Ery
TGTAACGTCTGAGGCC_3	Ery
TACACCCCACTTCATT_3	Monocyte
TCTATCAGTAGTGTGG_3	Monocyte
CCACGTTCAGTAGTGG_3	Monocyte
ACGGTCGCAATCCAGT_3	DC2
GATTGGTCACATATCG_3	Monocyte
AACGTCATCGATTCCC_3	MZ B
CTGCGAGAGAAGTCTA_3	DC2
GACTCAATCGGCCCAA_3	Ery
GTAGCTAGTGCAGATG_3	Plasma cell
TGGGCGTAGCACTCTA_3	DC2
AGCGATTTCCTTACCG_3	HSC
ACACGCGTCCTTCTTC_3	DC2
TTTCAGTCAACCTAAC_3	Monocyte
CGAAGTTCACAGCTTA_3	Plasma cell
AGGAATATCTATCGTT_3	ILC
TCGGTCTTCTATTGTC_3	Plasma cell
TAGGTTGCACTATCCC_3	Monocyte
GTCAAACCAACGAGGT_3	MZ B
TTGATGGTCTCAACCC_3	DC2
TCTGTCGCATGTACGT_3	DC2
AAAGTCCCATGGCACC_3	DC2
ACTGTCCAGCCTTTGA_3	DC2
GAATCGTTCGAGAAGC_3	DC2
GTTACAGCAGGTCCGT_3	ILC
GTCCTCATCGTCGACG_3	Monocyte
CTCTCGACAGGTGGAT_3	Mac
AGTCAACTCTGGGAGA_3	Monocyte
TTCCTTCAGCACTTTG_3	MZ B
GTAACCAGTGAGTAGC_3	Monocyte
CAACCAACATACTGTG_3	Plasma cell
TGATTTCTCGCCTATC_3	Monocyte
GGTCACGGTTCTGAGT_3	MZ B
TACTTACTCCGAGATT_3	DC1
TTCCTAAAGGTAAACT_3	DC2
AATAGAGTCATGGGAG_3	NK
ATTCACTTCGACCACG_3	Plasma cell
CACTGGGCATTCACCC_3	Monocyte
GTCTACCGTCTTACTT_3	DC2
GCGGATCCAGACGCTC_3	EC
ATTGTTCTCGTCCATC_3	Plasma cell
CCGTTCATCGTGCACG_3	Plasma cell
AGTACTGAGTACCCTA_3	Monocyte
GTTGTCCTCAGTGTGT_3	HSC
ATAGACCGTAGCGATG_3	Plasma cell
TGCGATACAATTGAGA_3	Monocyte
GGGTCTGAGCTAAATG_3	MZ B
ACTGATGCATAACCCA_3	Plasma cell
TAAGCCAAGGCCTGAA_3	EC
AACAAGAGTCGCATTA_3	Monocyte
AAGTTCGAGTCGCCAC_3	Mac
GTAATCGGTACTGTTG_3	Monocyte
TCATCATCAAACCGGA_3	Monocyte
TCGAACAAGATCACCT_3	Monocyte
ACGTAGTGTCGCTGCA_3	DC2
CGTGATATCTACGGGC_3	MZ B
CAGGTATAGAGGGCGA_3	Plasma cell
TCGAAGTTCCACTAGA_3	DC2
TCAAGTGGTAGACTGG_3	Plasma cell
CCCTAACTCTTGTGCC_3	EC
GACATCAGTGTTCCTC_3	Monocyte
CGTAATGTCTCATTGT_3	Monocyte
TATACCTCAGACAAAT_3	Plasmablast
GGTGTCGCATTAAAGG_3	Plasma cell
TGAGACTCACAGACGA_3	MZ B
ATTCTACCACAATGTC_3	MZ B
CTCATCGGTAAGCTCT_3	DC2
AAGGTAATCGTTCTAT_3	MZ B
TTCAATCAGGGCAATC_3	DC2
GTCTAGAGTGAATGAT_3	Monocyte
GATGAGGAGCTTTGTG_3	Monocyte
ATTCCTATCCGTGTGG_3	DC2
TGAACGTGTCGGTAAG_3	DC2
GGGTTTAAGACAGTCG_3	Plasmablast
GATTTCTGTACCAGAG_3	Monocyte
TTTAGTCGTGCAACAG_3	Plasma cell
CTACATTTCCAGTACA_3	Follicular B
CCTTTGGTCCACCTCA_3	Monocyte
GACTTCCGTAACAGTA_3	Plasma cell
CCGAACGGTTACGATC_3	Monocyte
GAGTGTTGTTCGTTCC_3	MZ B
GCACTAAAGTATAGAC_3	Monocyte
ATATCCTTCTCGACGG_3	DC2
TCAAGTGAGCAGTACG_3	Plasma cell
GCTGGGTGTCTTCATT_3	Plasma cell
GGGATCCCATCCGAAT_3	Monocyte
TGCTTGCGTATACAGA_3	DC2
CATGCTCCAGCCGGTT_3	DC2
TTAATCCGTAGGCAGT_3	MZ B
GCATCGGTCTTCTGGC_3	Ery
TCTCCGAGTGGTCCCA_3	Plasma cell
GAGAAATCAAGCCATT_3	Plasma cell
TTTCCTCGTTAGTTCG_3	Plasma cell
AGCGCCAAGAAATTGC_3	Follicular B
CGACAGCTCTAGTGAC_3	Monocyte
TAAGCGTCAGTTGAAA_3	HSC
GTTACAGTCTGCCCTA_3	DC1
TGGGAAGTCACAAGGG_3	DC2
GACCAATGTGGCAGAT_3	DC2
GGGATCCCAAATGGCG_3	DC2
GTCTAGACAGGTTCGC_3	DC2
TCATGCCCAAATGAGT_3	MZ B
GAGGCCTCAGGTCCGT_3	Follicular B
TGCTCCACACTCCGGA_3	EC
AAGACTCTCATGAGGG_3	DC2
TTTCGATAGGTTCTTG_3	Plasma cell
GCCGTGATCTGGTCAA_3	Monocyte
TGGTGATGTAACAGTA_3	MZ B
CTACATTTCTTCTTCC_3	ILC
CAATGACAGCTGGCCT_3	MZ B
GAGCTGCAGGCGCTTC_3	Monocyte
TCCGATCAGTGCTAGG_3	Plasma cell
ATCCGTCGTCTACGAT_3	Monocyte
CAGATTGTCCCTCAAC_3	DC2
TCCCACAGTTTAAGGA_3	Monocyte
GGGACAACAGCGGATA_3	DC2
CGACAGCAGTGTCATC_3	DC2
GAGGGATAGTTTCTTC_3	Monocyte
GTCATCCAGGTAGACC_3	Monocyte
TCACTCGTCTACCACC_3	DC2
TGGGCTGGTGGACTAG_3	Monocyte
TGTAACGGTTCCGCTT_3	DC2
TCAAGACAGTCAAGCG_3	Monocyte
CAACCTCTCGACACCG_3	Plasma cell
GCGTTTCAGCGAGAAA_3	Monocyte
ATTCTTGCAAACTCTG_3	Monocyte
GGGATGAGTATAATGG_3	DC2
AAGTACCCATCGATCA_3	DC2
GCATTAGGTAGAGGAA_3	Monocyte
TTGTTGTGTATGCGGA_3	ILC
AACGAAAAGTCCCTAA_3	Monocyte
AGCCACGTCATAGAGA_3	Monocyte
TGGGAGAGTAGCACGA_3	Plasma cell
GCACTAAAGATGCTAA_3	Monocyte
GTGAGTTCAGAACTTC_3	HSC
CTTGAGACAAGGTCAG_3	Plasma cell
GGGTTATTCGTCGGGT_3	Plasma cell
GACTGATTCCGGACGT_3	Monocyte
GACTGATAGTACTGGG_3	DC2
ATCCGTCAGCATGAAT_3	DC2
GACCCAGTCCACGAAT_3	EC
AGGGTGAAGGTGCCAA_3	Plasma cell
GCCATTCAGAGTGACC_3	Monocyte
CATGAGTGTGTCTTAG_3	Ery
CCGTTCATCCAAATGC_3	Monocyte
TGAGGAGCATTCCTCG_3	Monocyte
CTCACTGCAACATACC_3	MZ B
ACGGAAGTCATCACAG_3	DC2
ATGAGTCTCACGAACT_3	MZ B
GGCACGTCAAGTGGCA_3	Monocyte
AACCTGATCGAGAAAT_3	DC2
TCTATCAGTATTTCGG_3	Mac
TGGAGGACAGCGGTTC_3	DC2
GATCAGTGTTGTGGCC_3	Monocyte
GAGTCATTCGCTTACC_3	DC2
GTGCTGGGTTCGTACA_3	DC2
TACGGGCAGTCGGGAT_3	HSC
GTAGAGGCATCTGGGC_3	ILC
TGCAGTAGTACGACAG_3	DC1
TGTCCTGGTAACCCTA_3	DC2
CTCTGGTGTAACGTTC_3	Monocyte
GGGATCCTCAGCACCG_3	DC2
ATTCGTTTCAGATTGC_3	Plasma cell
TCATTCAGTATCTCGA_3	Monocyte
CCTCATGTCGGTGCAC_3	Plasma cell
CATGCAATCCACGAAT_3	DC2
TCTACATCAGCAGTAG_3	EC
GCTACCTCATTGTAGC_3	Monocyte
CTATCCGGTGCATGAG_3	MZ B
TCGCACTCATGGGATG_3	Monocyte
ATGACCACATTCAGCA_3	Follicular B
AGGACTTCACCTATCC_3	DC2
CTTCCTTCAGGCTTGC_3	EC
GCTTTCGGTGTACATC_3	Monocyte
ACTGTGACATGCCGGT_3	Plasma cell
CATTGCCCAGAACCGA_3	Monocyte
ATTACTCAGTATCCTG_3	MZ B
CGACAGCCATTGACTG_3	Plasma cell
TCGCAGGTCACATTGG_3	DC2
AGATGCTTCGGTCACG_3	DC2
CTAAGTGTCGACCACG_3	MZ B
TCTACATTCGGCGATC_3	DC2
TTGGGATCAAGGTTGG_3	DC2
GTCATGAGTGACAGCA_3	Monocyte
ATGCATGAGAAGCGGG_3	Monocyte
GTTATGGTCGTAATGC_3	Monocyte
GTAGATCAGAGAGTGA_3	HSC
TGTCCTGCAAGCGCAA_3	Monocyte
CGAGAAGAGTTTAGGA_3	Monocyte
TAGGTTGGTCATGACT_3	DC2
TCAATTCAGATGTTCC_3	Monocyte
ATTCTACAGGATACCG_3	Plasma cell
TTACGTTGTATGCTAC_3	EC
GATCGTAAGCCGATCC_3	Monocyte
GCCATTCCAAAGGCGT_3	Monocyte
GGGCCATAGAGCCATG_3	DC2
TCGACCTCACCTCAGG_3	Monocyte
TGAGGTTAGTCACTAC_3	MZ B
TCCTTTCAGCGTTACT_3	MZ B
TCTTAGTCATGAGAAT_3	Monocyte
TCATGAGCAAAGGCAC_3	Monocyte
AGAGCAGGTCTGCCTT_3	DC2
TACGGTACAAGCTGTT_3	DC2
TCAGTCCCACAAATCC_3	Monocyte
TGTAACGAGGTAGTCG_3	ILC
CGAATTGCAAATAAGC_3	Monocyte
GTGTTAGAGTCGAAAT_3	Monocyte
AGGCATTCAATCGCCG_3	Plasma cell
CAGCAATTCGAGAATA_3	Monocyte
CTCAACCTCAAGCCCG_3	Plasma cell
GTTCGCTAGATGACAT_3	Monocyte
GGCGTCACAAGAGATT_3	Monocyte
ATGTCTTTCCGAACGC_3	Follicular B
TCATGGAGTTACCCAA_3	MZ B
CGTGAATAGGTTACCT_3	Monocyte
GCCTGTTTCTTGCAAG_3	DC2
GAGATGGAGCCTCCAG_3	Monocyte
GAGTTACCATCGGTTA_3	Monocyte
AACACACTCGAACGCC_3	Plasma cell
TGCTCCACATGTTTGG_3	Monocyte
ATCCTATGTCAAAGCG_3	Monocyte
AGAGCAGTCGTCTAAG_3	Monocyte
CTCACTGAGGTTGCCC_3	MZ B
ATGAGGGTCTGACAGT_3	Monocyte
GATGGAGTCACCCTCA_3	DC2
TTGTGGATCAAATGAG_3	MZ B
TACTGCCGTTCCATTT_3	Monocyte
GCGTTTCCAGGCTTGC_3	MZ B
GGAATGGGTCCTCAGG_3	Monocyte
GTCCTCACATAGACTC_3	Monocyte
ATGTCCCAGTGTACAA_3	Monocyte
TGTCCACCATTCATCT_3	DC2
AGGTTGTCAGGTTACT_3	Follicular B
AGCATCATCAGAATAG_3	MZ B
ATATCCTCAATTGCAC_3	MZ B
TTGTGTTCATCGATGT_3	DC2
TACCCACTCTGGACTA_3	Monocyte
CACGTTCGTAACTTCG_3	MZ B
CTCTCAGCAGATACCT_3	Mac
GCAGTTAGTCAGACGA_3	DC2
ATGTCCCTCCACCTCA_3	MZ B
AAGCGAGCAACGACTT_3	MZ B
CATCAAGTCTACTATC_3	MZ B
GAGAAATGTTCATCTT_3	Plasma cell
CCGAACGCAATCTGCA_3	Plasma cell
CGAGTGCCAGCAGTGA_3	DC2
GAGTCTAGTTCCAGGC_3	Monocyte
AGCGTATAGTATAGAC_3	MZ B
TTTCATGGTACTGGGA_3	Monocyte
ATGGGTTGTAGCGCCT_3	MZ B
GCCGATGGTTCCTAGA_3	Monocyte
CACAACATCTCCGCAT_3	Monocyte
GCCAACGCAGCAATTC_3	MZ B
CCTCCAATCTGAGGTT_3	Monocyte
CTAACTTGTCCAGCAC_3	Monocyte
TGTGCGGGTTGCGAAG_3	Monocyte
CAGCCAGGTATACGGG_3	Mac
TATTCCAAGAGAATCT_3	Monocyte
GTGTTAGCACCCTGAG_3	Monocyte
GATAGAAAGAAGGTAG_3	Monocyte
TACTTCAGTATCTCGA_3	Monocyte
TCAGTTTAGCGAGTAC_3	HSC
TCGTGCTAGAGCTGAC_3	Plasma cell
CTACAGAGTCGTGCCA_3	MZ B
ATGGGAGTCTGCGGGT_3	EC
AAAGGATTCGGTTGTA_3	Monocyte
ATGTCCCCACGGTGCT_3	Monocyte
GGTTGTAGTGACGTCC_3	EC
TCGCTTGCATGTAACC_3	Monocyte
CTGTGGGTCCCACAGG_3	DC2
TACCTGCCAGGTGTTT_3	DC2
TCGCAGGCAAATCGGG_3	DC2
TCGGGCATCCCATAAG_3	DC2
TTCCGTGAGCCGTTAT_3	ILC
CTGCATCCAAGCACCC_3	Follicular B
GAGCCTGGTAGGTTTC_3	Monocyte
ATCACAGAGGTGAGCT_3	DC2
ACAACCAAGCGCTTCG_3	Monocyte
CAGTGCGGTATACCCA_3	Monocyte
TCGGGACGTGGTAACG_3	DC2
TTGGGCGGTATCTTCT_3	Monocyte
AGATGAACATGTTTGG_3	Mac
CCTTCAGTCATAGCAC_3	EC
TTTACCAGTTCCTAGA_3	Monocyte
CTCAATTGTAGTCCTA_3	MZ B
TACCGAATCTGCCTGT_3	Monocyte
AGTGACTCATCCTGTC_3	MZ B
CTGATCCTCGGTAGGA_3	EC
TCGTCCAAGGCGATAC_3	Monocyte
TGACAGTGTATGCTAC_3	MZ B
ATCACTTCAAAGAGTT_3	DC2
ATAGGCTCATTAGGCT_3	Monocyte
TGCCGAGAGGTACAGC_3	DC2
TTCACCGAGGTTTGAA_3	Monocyte
GACAGCCTCACTGGGC_3	MZ B
AGGTTACTCGGCTGAC_3	MZ B
CAATGACTCCCAACTC_3	Fibroblast
TATCTTGGTGTTCCAA_3	MZ B
CCATAAGAGCACTCTA_3	MZ B
TCGAAGTAGATCCGAG_3	Monocyte
GTCTAGATCCCTATTA_3	MZ B
CACTGGGCATGGGAAC_3	Monocyte
TGTTTGTTCACCTCTG_3	CD4+ T
CTCAGGGAGCATGCGA_3	Monocyte
ACAAGCTTCGCGTTTC_3	Monocyte
TCGCAGGCAAATTGGA_3	ILC
ACCATTTTCGAAACAA_3	Monocyte
TTGTGTTTCGAACTCA_3	Ery
GCACTAACAAGTGGGT_3	DC2
CCATCACAGGGTCACA_3	DC2
AGGCCACCAACTCCCT_3	EC
TACTTGTTCCACGAAT_3	EC
CGGAACCTCCGTTGAA_3	Monocyte
CCAATTTCAGAGAGGG_3	Monocyte
GCTTCACAGCATGCGA_3	MZ B
CGTGAATTCCTTTAGT_3	Plasma cell
TTTCAGTCAAAGACTA_3	Monocyte
AACAGGGAGAGAGTGA_3	MZ B
TGTGGCGTCATGCCCT_3	Monocyte
ATCGTAGTCTCACCCA_3	Monocyte
CATTTCACAACGGCCT_3	DC2
AGACAAATCTAAGCGT_3	Monocyte
ACCAACATCTATGCCC_3	Monocyte
TTGAACGGTATAGCTC_3	DC2
AGTTCCCTCGTAATGC_3	MZ B
TAGGGTTTCCCGTGTT_3	Monocyte
GTAATGCGTCGAGCTC_3	HSC
TGATCAGCATTACTCT_3	Monocyte
GTGCAGCGTTCGCGTG_3	Monocyte
GAGATGGGTTATAGCC_3	Monocyte
CTTCTAATCTTAATCC_3	MZ B
TGGAACTAGAGGACTC_3	CD4+ T
GACGCTGTCATCGGGC_3	Plasma cell
AGTAGTCCAATGCAGG_3	Monocyte
GGGCTCAAGATGAAGG_3	DC2
TATTCCATCAGTGCGC_3	Fibroblast
CAATTTCAGCGTGTCC_3	DC2
TGGGATTTCGCCGTGA_3	DC2
GTTACAGGTGTTGAGG_3	Mac
GGTGTTACACGCTGAC_3	EC
CAGTGCGGTCCTCATC_3	Monocyte
TCAAGACGTGGATACG_3	Monocyte
GTCACTCAGGAACGCT_3	Ery
GAGTTACCATGCCGGT_3	Monocyte
AATAGAGGTCGCAACC_3	DC2
GCACGTGCAGTCAGTT_3	MZ B
ATTGTTCTCCGCGGAT_3	MZ B
TATTGGGTCCCGTTCA_3	Mac
GATAGAAGTGTGTTTG_3	MZ B
CATGCGGCAACTGCCG_3	Monocyte
TATCAGGCATGATAGA_3	Monocyte
CAATTTCAGAACCCGA_3	Mac
CTCCTCCCAGGATCTT_3	Monocyte
TTCGCTGTCTAGGCAT_3	Follicular B
CTACCTGAGACTCCGC_3	Follicular B
ATCGGCGGTTGCTAGT_3	MZ B
GTCTCACGTAAGGTCG_3	Monocyte
TTACGCCTCGCAACAT_3	MZ B
CCCTCAAAGGTACAGC_3	Monocyte
CCAAGCGCACCGCTAG_3	MZ B
AGAACAACATCATTTC_3	Follicular B
TCCTTCTGTACTCAAC_3	Plasma cell
GCTACAAGTGATCATC_3	Monocyte
ACTTATCGTAGTGGCA_3	Mac
CATGGATGTGTCATGT_3	DC2
AGTACTGTCTGATGGT_3	MZ B
ACATCCCGTCCACTCT_3	MZ B
CCTCAACAGTGTTCCA_3	Plasma cell
ATTGTTCAGCACGGAT_3	DC2
TGTTACTAGGCGAAGG_3	Monocyte
TCAGCAAGTAATCAAG_3	MZ B
CGGGTCATCATCCTGC_3	Monocyte
CAGGCCATCGTCGCTT_3	Monocyte
GAGGCCTAGCCTCAGC_3	Monocyte
CGCCAGACACGACAAG_3	Monocyte
TTTGATCTCTATGCCC_3	MZ B
GACGCTGTCTTAGTTC_3	Mac
GGGTTATGTATTGCCA_3	MZ B
GACTATGCACATCATG_3	MZ B
GAGGCCTTCAAAGCCT_3	MZ B
GTTGTGAAGGCCTGCT_3	ILC
GGAGCAAGTTCGTACA_3	DC2
AGCGTATCAGCACACC_3	Monocyte
TCAAGCAAGACGCAGT_3	Plasma cell
CGGAGAACAACCGCCA_3	Mac
GTCATCCGTGTCTTCC_3	DC2
CAACAACAGTATGCAA_3	DC2
GCGGATCTCGAGATAA_3	MZ B
GGAATCTGTAGCCCTG_3	Follicular B
TCATTCAGTACGTGTT_3	Monocyte
AACCACATCGTAATGC_3	Follicular B
GTGTCCTCACACGTGC_3	MZ B
CTGCATCTCTATTGTC_3	MZ B
TGATCAGTCAAGTCTG_3	MZ B
TTCGGTCCAATCACGT_3	Monocyte
CTACAGAGTTGAGGAC_3	Mac
GGGTTTAGTAAGGCCA_3	DC2
TGTTGAGCAGGAGGAG_3	DC2
ACTGTGAGTACTGCGC_3	MZ B
AGCCAGCCAGCGTTGC_3	MZ B
GTATTTCGTGATCATC_3	Monocyte
TGCGGCACACTCTAGA_3	Monocyte
TCCTAATAGCTAGAAT_3	MZ B
GAAATGACAGCGAGTA_3	MZ B
TGAGACTCACAAATGA_3	Monocyte
TCGATTTAGACTTCCA_3	Monocyte
CGTCCATTCCTTGACC_3	Monocyte
ACAGAAACAGACCCGT_3	DC2
CTCCATGGTGAAGCGT_3	Monocyte
CTGAATGTCGGTGCAC_3	EC
TCCGGGACATGGAATA_3	Monocyte
AAGACTCAGTGTGTTC_3	DC2
ATAGACCTCCGAAGGA_3	DC1
ATCACGATCTGAGGTT_3	Monocyte
ACCAACACATCCGATA_3	Monocyte
GGGTAGATCCGAGCTG_3	MZ B
TAACACGGTACGCTTA_3	ILC
GAACTGTCATCCGTTC_3	MZ B
TTGAACGCATCCCACT_3	Follicular B
GCTCAAAAGTGCCCGT_3	Monocyte
ACGATCACACTTCAGA_3	MZ B
TCACAAGGTATGGTTC_3	Follicular B
TTAATCCTCCTATTGT_3	DC2
GAGTGTTAGGGTTTCT_3	Follicular B
TTTCATGAGAGTATAC_3	DC2
CCACAAATCCAAGCCG_3	Monocyte
CACAACATCTTTCGAT_3	Monocyte
GATTGGTCAATGTCTG_3	Monocyte
GGGAGTATCTCTCTAA_3	MZ B
GCCAGTGCAGCACGAA_3	MZ B
TCACAAGAGGTAAGGA_3	DC2
ACATCCCTCAACTCTT_3	MZ B
TATCCTAAGACTTAAG_3	Follicular B
ATGAGTCCATACTTTC_3	MZ B
TCGAACAGTCCGACGT_3	MZ B
GTTTACTGTAATGTGA_3	Monocyte
ATTCCATTCATCCCGT_3	DC2
ATGGTTGAGTGATGGC_3	DC2
ATCATTCAGCGTCTGC_3	Monocyte
TTACGCCCAGCGTTGC_3	DC2
GGGTTTAGTCCTACAA_3	Monocyte
CTCTCAGGTAACGTTC_3	MZ B
GCTTGGGAGGGTTTCT_3	DC1
CAGCGTGGTTCGTAAC_3	Monocyte
TCAAGACCAGCGTACC_3	MZ B
TTGCATTCAGGGCTTC_3	CD4+ T
GAAGAATTCCGCAAAT_3	Monocyte
TTGTGGAAGGTCGTAG_3	Monocyte
GTTGCGGGTACTGCGC_3	Plasma cell
TATTTCGCAATTGGTC_3	MZ B
TCCTCCCAGATTAGAC_3	Follicular B
CCATAAGTCCACGTAA_3	Plasma cell
CACGTGGTCGCCTTTG_3	EC
TGGATCAAGCTTCTAG_3	Monocyte
TTCCTCTAGGAGATAG_3	Mac
AGGTTGTGTGTTGAGG_3	Monocyte
CAGTTCCTCCGCACGA_3	Monocyte
TGAGCGCCAGCTGTTA_3	Monocyte
GAAGGGTAGTCCCAAT_3	EC
TCGGGCACACTCTCGT_3	Monocyte
TTACCGCTCGAAGGAC_3	Mac
TATTGGGTCACTTGGA_3	Plasma cell
GAGGCAATCACTGTTT_3	ILC
CTCAAGATCGTAATGC_3	MZ B
GGAATGGTCTATTTCG_3	Monocyte
GACTGATAGGTCCAGA_3	MZ B
TTCTTCCTCGAGAACG_3	Mac
GTGGAAGAGAGGGTAA_3	Monocyte
TGGAACTGTGACTGTT_3	Monocyte
TTGATGGAGCGATGAC_3	Monocyte
GTAATCGGTGAGACCA_3	Monocyte
TAGGTACTCAACGCTA_3	MZ B
GGCGTCAAGGGAGGCA_3	Monocyte
CGAATTGTCACGACTA_3	EC
TAACTTCAGTTGCATC_3	MZ B
TCTAACTCAGCTCCTT_3	Follicular B
CACGGGTGTACGGCAA_3	Monocyte
CAAGAGGCATTCTCCG_3	Monocyte
AGTGCCGAGTGGTGGT_3	Ery
CTGTAGAAGGCCTGCT_3	MZ B
AGGCCACGTCTTCTAT_3	Monocyte
AAGACTCGTCGTACAT_3	MZ B
GAGGGATGTAGCTGCC_3	Monocyte
CAACAACTCGTTGTAG_3	Monocyte
TCAAGACTCAAGGACG_3	Monocyte
ATGGGTTCAACTGCTA_3	MZ B
TTCAATCGTATACCCA_3	Plasma cell
ACCATTTGTGGAAGTC_3	DC1
GCGGATCTCAACCGAT_3	Monocyte
CGAAGTTAGATTACCC_3	DC2
AGTCTCCAGCTGCCAC_3	Monocyte
CCACGTTTCTGAGAAA_3	MZ B
AGGTCATTCAAAGGTA_3	MZ B
GTCAAGTGTGATTCTG_3	MZ B
TCACATTTCCCAGTGG_3	MZ B
GAAGGGTGTCCTCCAT_3	Monocyte
CTGTGAACAAGAATAC_3	EC
CTACCTGAGACGCCAA_3	ILC
CCGATCTAGCCTCTGG_3	Mac
GTCACTCCATGTTCAG_3	Monocyte
CTGTCGTGTTCTCACC_3	Monocyte
ATCCATTCAACTTCTT_3	CD4+ T
CTCCCAAGTTCCGCGA_3	Mac
AGTCACATCCTCTGCA_3	MZ B
TCGATTTAGAAGCTGC_3	Monocyte
GGAACCCTCCTCGATC_3	Follicular B
GATGATCAGCCTGTGC_3	Monocyte
CCTTCAGTCTTCGTAT_3	MZ B
GCCCAGAGTAGCGCTC_3	Follicular B
CTCAACCAGAGAACCC_3	MZ B
TGCGACGGTACGTGTT_3	Monocyte
TTTAGTCAGATACTGA_3	MZ B
TATTCCACAAGACAAT_3	Mac
GACAGCCCAGCTCATA_3	Monocyte
AGCTTCCGTGTTAAAG_3	Monocyte
TCGTCCATCTACGCAA_3	MZ B
CCCTGATTCTCGGTCT_3	DC2
GTGTGGCGTTCCGCTT_3	DC2
TGGAACTAGTTGCTGT_3	Monocyte
GAGTTGTGTCTTACAG_3	Monocyte
TACCCGTAGTTGCCCG_3	Follicular B
ACACAGTAGTAAACTG_3	MZ B
ACATTTCAGCTAGCCC_3	Follicular B
TCTCAGCAGAAATTGC_3	MZ B
AAGATAGTCCATACTT_3	Monocyte
GCAGCCAGTGAGTAAT_3	Monocyte
CGTGATAGTTTCGTAG_3	Monocyte
CGAGTGCAGCGTCTCG_3	Ery
CAGCCAGAGAGAGCAA_3	Monocyte
CTACTATAGGGTACAC_3	Follicular B
CCAAGCGAGCCTTTGA_3	Monocyte
GCACTAACATGACTGT_3	MZ B
CTACCCAAGTTTGGCT_3	ILC
TTCCGTGTCTCCGAAA_3	Mac
TCACGGGGTTGCCGAC_3	Monocyte
ACGGGTCAGTTGGCGA_3	MZ B
CTAACTTGTATTGCCA_3	EC
GCAACATCAAATGCGG_3	Mac
TACTTGTCATGGCCAC_3	Mac
ATCAGGTGTTCGAAGG_3	Mac
AACCCAACAGTGGGTA_3	Monocyte
CATAGACCAGGTTACT_3	MZ B
TGCGACGCAATTTCCT_3	Follicular B
GTGTGATCACTGAGTT_3	CD4+ T
GAGCCTGGTTAGCGGA_3	Monocyte
TCGATTTCAACGGCCT_3	Monocyte
CAAAGAAGTTGCCTAA_3	Monocyte
ACTATCTGTCATCACA_3	Follicular B
AAGGTAACATTCTGTT_3	Monocyte
ATCCTATAGTCACTCA_3	Monocyte
CCTCAACGTATGGAGC_3	MZ B
GGTGTCGAGGTATTGA_3	MZ B
TTCGGTCTCCATACTT_3	Plasma cell
CTCATGCAGCTAGAGC_3	Monocyte
TCCGTGTGTCCAATCA_3	Monocyte
ATCGTGAGTATCGTGT_3	Plasma cell
GAAATGAGTCTACATG_3	MZ B
GCCGATGTCCTGGTCT_3	Monocyte
TCACTCGCAGTAACCT_3	Monocyte
AGGGTGAGTTGCCGAC_3	Mac
CAGCAGCGTCAACGCC_3	MZ B
TCCGGGAGTTACAGCT_3	MZ B
CCTCAACCACTCCGGA_3	Follicular B
TTCAATCGTCGCATCG_3	EC
AATCACGTCATCTACT_3	MZ B
TACGGTAAGTTTCGAC_3	Mac
GAGGCCTCAGCAGTCC_3	Monocyte
CAGATACGTTGAGGAC_3	MZ B
AAGCGTTCATACCATG_3	MZ B
ATTATCCGTCGAATTC_3	Monocyte
CCGTGAGGTGAACTAA_3	Monocyte
GGGTAGATCGCTGTTC_3	Monocyte
AAACGCTGTCGTATTG_3	Follicular B
AAGGAATCACTTCAAG_3	Plasma cell
CTGCTCAGTGTTAAAG_3	Monocyte
ACGTAGTAGAATAACC_3	MZ B
CTGTATTAGGTCCAGA_3	MZ B
CCCTCTCAGTCACTCA_3	Follicular B
ACGCACGTCAGACAAA_3	Monocyte
TGCAGTAAGGTTGACG_3	Plasma cell
AATCACGGTATGGTAA_3	Monocyte
GTAGCTATCCAGTACA_3	Monocyte
ATCTCTATCTGTCCCA_3	Ery
AAAGGATCATCATCCC_3	Plasma cell
TATATCCAGAGAGCAA_3	DC2
AGACCCGAGGTTGTTC_3	DC2
GTCCACTAGGCGTTAG_3	MZ B
ACATCGAAGGAACATT_3	MZ B
ACTTATCAGAATTCAG_3	MZ B
GGTGTTAGTCGTATGT_3	MZ B
TGTGTGAAGAGCAGAA_3	Monocyte
TCTTAGTTCAAGGCTT_3	Monocyte
ATAGGCTTCTCGCTCA_3	CD4+ T
TCACATTGTTGCTTGA_3	MZ B
GCAACATAGAGCGACT_3	MZ B
TACTGCCTCTCACTCG_3	Mac
AGAACAAAGAGTGAAG_3	Monocyte
CTCATGCAGGATGGCT_3	Monocyte
CGAATTGGTCGGCACT_3	Mac
GAACGTTTCATTGGTG_3	Monocyte
AGTTCGAGTCTTGCGG_3	Follicular B
CACCAAACAGGCATGA_3	EC
GCCATGGTCCATAGGT_3	Monocyte
AGTAACCCACTACCGG_3	Monocyte
AACAAGATCCGTATAG_3	Monocyte
TCCATCGGTAGTGATA_3	Monocyte
AGCGCCATCGAAGGAC_3	Monocyte
GATGAGGCAGGACTTT_3	Mac
ACTATCTTCGCCAGTG_3	MZ B
GCCAGTGCACTACCCT_3	MZ B
TACAGGTAGACCAGCA_3	EC
ATCCGTCAGTCAGCCC_3	Monocyte
ATGGGAGGTCTGCATA_3	Plasma cell
AGAGCCCTCTGGGATT_3	MZ B
GACCGTGCAATGGCCC_3	MZ B
GAAGTAACAAGCACCC_3	Plasma cell
TACATTCCATGTGGCC_3	Monocyte
GTGCACGAGAGCAACC_3	Monocyte
GACTATGGTCAACACT_3	Follicular B
CAGCAGCCAGAGGACT_3	Monocyte
GCTGGGTAGCCAAGGT_3	MZ B
TGGGTTAAGTTTCGGT_3	Monocyte
CAGCGTGGTGATACTC_3	Follicular B
GAACGTTCAAATGCTC_3	ILC
AGGGAGTTCGCAGTGC_3	Follicular B
CACTGTCTCATGGATC_3	MZ B
TGACCCTTCTAGGAAA_3	Monocyte
TATTGGGCATGACGTT_3	MZ B
TTACGTTCATCTGTTT_3	Monocyte
GATTTCTTCACTGATG_3	Fibroblast
GTTGTCCGTCTGATAC_3	Follicular B
GACTTCCTCTGCGGGT_3	Monocyte
ACAACCAGTGTTAGCT_3	MZ B
AGGTTACTCGTTCCTG_3	Plasma cell
GTAACCAGTATTCTCT_3	MZ B
TTCAGGAAGTGACACG_3	MZ B
TCTTAGTTCACGAACT_3	Monocyte
GTGGGAATCGCCTTTG_3	Follicular B
GAGTTGTAGCTCCGAC_3	Follicular B
ACGGTTAAGGCCCACT_3	MZ B
ATTATCCTCCGCAGTG_3	Follicular B
ACGTAGTCATGACGAG_3	Monocyte
TAATTCCTCAAGCCGC_3	Fibroblast
TCCCATGGTGTGAATA_3	Monocyte
GAGTGAGTCACCGGTG_3	MZ B
CGAATTGTCCTCTGCA_3	Follicular B
TGCTCGTAGTCGCCCA_3	Monocyte
TGTGAGTAGAATCGAT_3	Plasma cell
TAGACCACATCAGTGT_3	Fibroblast
TCAAGCAGTAGGGAGG_3	Monocyte
ATGAGGGAGGGCAGAG_3	MZ B
CACTGTCAGCATACTC_3	MZ B
GAAGGGTGTTACACAC_3	Follicular B
ACTGATGAGCGAATGC_3	Mac
GATCCCTAGAGTACCG_3	MZ B
ACCATTTAGAGTAACT_3	Monocyte
TGCGGGTTCCTGTACC_3	Mac
CCTAACCCAGCGTGAA_3	Monocyte
TCACGGGGTCTACATG_3	MZ B
TGGGTTACATCCGTTC_3	Monocyte
AGTAGCTGTATGATCC_3	CD4+ T
CAACCTCAGCGATGCA_3	MZ B
TCTCTGGCACTCCGGA_3	Monocyte
GCGGAAACATGTGGCC_3	Follicular B
CACAGATAGGCCACTC_3	Monocyte
AGGACTTGTGCGACAA_3	Follicular B
GATGTTGTCAAAGACA_3	MZ B
ACTATGGCATGGAACG_3	MZ B
CATCCCAGTAGGCTGA_3	Monocyte
TTTACGTCAGATCCAT_3	Follicular B
ATTCGTTTCTCATTAC_3	Follicular B
TCATGTTCAAATGGCG_3	MZ B
TGGATGTCACCAGCTG_3	MZ B
TCCAGAACAATACAGA_3	Monocyte
TGGGAAGCAAGTCGTT_3	Monocyte
TACCTGCAGACTGGGT_3	Monocyte
GTCGTTCTCTACCCAC_3	DC1
TGTGGCGAGGTCCGAA_3	MZ B
AGACACTGTACAGAAT_3	Monocyte
AGTTAGCCAGCATCTA_3	MZ B
TGAGGTTCACCAAATC_3	Mac
TGGATCACAGTCGTTA_3	MZ B
GTCGTAAGTAATGCGG_3	DC2
TCGAACAGTCTTGTCC_3	Fibroblast
TGACTCCAGGGTACGT_3	Monocyte
ATTCCCGAGACCAGCA_3	CD4+ T
GGTTGTATCTAAGGAA_3	NK
CTACATTCAGTCGAGA_3	Monocyte
TGAGGTTAGAATACAC_3	CD4+ T
AAAGAACCAATTTCCT_3	EC
CGGGACTGTTTCCATT_3	Mac
CAGTTCCGTCACTACA_3	CD8+ T
CTGCGAGGTAAGCTCT_3	Monocyte
GCGGATCTCGTAGGGA_3	Monocyte
TGAGCGCGTACGATGG_3	Monocyte
CCACAAATCGGTCACG_3	Ery
ACCTGTCCACCGAATT_3	Follicular B
CCACCATGTCATAAAG_3	Monocyte
TGCACGGGTTCATCTT_3	MZ B
ATATCCTAGCACGATG_3	Monocyte
GACTCTCAGATCCTAC_3	Monocyte
ACATCGATCCCAGTGG_3	Monocyte
CTTCTCTTCTGGTTGA_3	EC
TTCTTGACAAATGAGT_3	Monocyte
GCCATTCCAAATAAGC_3	Mac
TTTACGTGTTCTCGTC_3	Follicular B
CAATGACGTGTTGATC_3	Monocyte
TCAAGCACAGGTGAGT_3	CD8+ T
GAACGTTAGACTCTAC_3	Monocyte
TTCTAACGTGGCTTAT_3	Mac
TCGCTTGCACGTGTGC_3	MZ B
CTCCTTTCATAACAGA_3	MZ B
AAAGTGATCTGTCAGA_3	Monocyte
AAGTGAACAGTTGTTG_3	MZ B
ATGTCCCAGTCAGAGC_3	Monocyte
ACAGCCGCAGCCCACA_3	CD4+ T
CTGGACGGTGGAACCA_3	Monocyte
GCACGTGGTCTAGATC_3	Monocyte
TGCAGATGTCCTATAG_3	Follicular B
CTCCACATCGGTGTTA_3	Monocyte
AGAGAATGTTAGTCGT_3	Monocyte
CATCCCAGTCCTCCAT_3	MZ B
GTGCTGGCAGCTCTGG_3	EC
ACGGAAGAGGGCCCTT_3	DC2
TTTCGATTCAAATAGG_3	Monocyte
TACTGCCTCAGAATAG_3	Monocyte
AGTAGCTTCACAAGAA_3	Monocyte
GAGCTGCCAGGAATCG_3	EC
TATCTGTTCCGATAAC_3	Monocyte
CGTAAGTGTGGATCAG_3	Monocyte
GCAGCCACACATAGCT_3	Monocyte
GATTCGAAGAGCAGAA_3	Ery
TCAGTGAAGTCTAGCT_3	Mac
TTTACTGAGTTGGAGC_3	Ery
AAGGTAACAAATGCGG_3	MZ B
CACCAAATCACGATCA_3	Monocyte
ACTCTCGAGGACGCTA_3	EC
AGAGAATAGTATTGCC_3	Monocyte
CGTTGGGTCGGCACTG_3	Monocyte
TTGCGTCCAGAACTCT_3	EC
GGGTCTGAGCGAGGAG_3	Monocyte
TAAGCACGTACCGGAA_3	DC2
ATCCCTGAGAAGCCTG_3	Monocyte
ACGGGTCAGATGCTTC_3	MZ B
GTGGTTACATATAGCC_3	CD4+ T
TAAGTCGTCCACGTGG_3	NK
TTCCACGGTGCCTGAC_3	Follicular B
CTGGACGTCGCACTCT_3	Monocyte
TGACCCTTCGTCGATA_3	Follicular B
GGTAATCGTTTGGGAG_3	ILC
AGGCTGCAGTCATTGC_3	Monocyte
TATCCTAAGCGCTGAA_3	Monocyte
GTTACAGTCGCTCCTA_3	Monocyte
AAGCGTTCATCGAACT_3	Follicular B
GTCGAATCATGATCTG_3	Ery
CTATCCGGTTTGCCGG_3	Monocyte
CCTGCATAGGGCCAAT_3	CD4+ T
TCTGCCAAGGGTCACA_3	Follicular B
CTGAATGCAACAAGAT_3	MZ B
TGCATGAAGGTCACCC_3	MZ B
AGAAGCGGTTCCCACT_3	MZ B
TGATGCAGTGGTCTTA_3	MZ B
CGTAATGTCCGACATA_3	MZ B
TGGTAGTAGTGCCCGT_3	MZ B
CTGTACCTCGTGCAGC_3	Plasma cell
ACGTAGTTCCGTCCTA_3	CD4+ T
AGAGAATAGGTTGTTC_3	Monocyte
TTACCATCAGCGTTTA_3	Monocyte
AGTACCACAGGTTTAC_3	Monocyte
ATGGGAGAGCAGTACG_3	Monocyte
GAATAGAGTATTCTCT_3	Ery
TCGTCCAGTCTTCATT_3	Monocyte
ACTGCAACACTGTGTA_3	MZ B
CACGTGGGTGGATCGA_3	Monocyte
AGCGTATTCTCTATGT_3	Monocyte
GACTTCCTCGACGATT_3	CD4+ T
CCTCTAGTCGCCTCTA_3	Plasma cell
ATCAGGTCATCCGAAT_3	CD8+ T
TTGTTTGGTGCAAGAC_3	Mac
CAATCGAAGTGTCATC_3	MZ B
CGGGTGTAGAACTCCT_3	Monocyte
CCAATTTCACGTAACT_3	CD4+ T
AGGATAATCCACACCT_3	Follicular B
TATCCTAGTGCTCTCT_3	Mac
TAACACGTCATGCCGG_3	Plasma cell
GTGACGCGTGATAGAT_3	MZ B
ATTACCTAGCTGTTAC_3	MZ B
TGGTACACAAAGACTA_3	CD4+ T
TCGTGCTCACGTTGGC_3	Follicular B
CGAGGAAGTTTAGAGA_3	DC2
TCACTCGTCGACATTG_3	Ery
ATTCTTGAGTAGTCTC_3	MZ B
TTTACTGCAACAGAGC_3	Ery
GTGTTAGCAAATGCGG_3	MZ B
GAGTGTTCAAAGAACT_3	MZ B
TGTTGAGGTATCGCGC_3	MZ B
TGCGGCATCGTCCTCA_3	MZ B
CCTATCGAGGTAGTAT_3	Monocyte
CTTCCTTCAAGCGCTC_3	Monocyte
TACCCACTCTTCCCAG_3	EC
TTCCTTCCATTCAGCA_3	CD8+ T
AGGACTTGTCTGCATA_3	CD8+ T
GAGGCAATCAAGATAG_3	Follicular B
TTGGGATAGGTTAAAC_3	Monocyte
TGACAGTGTAGTCTTG_3	Monocyte
ACAGCCGCAAAGCACG_3	MZ B
TGGGAAGCATAGAGGC_3	Monocyte
TCACACCAGGCTCTCG_3	Follicular B
GACAGCCGTCGAGCTC_3	MZ B
CACAGGCTCAAGAGTA_3	Monocyte
CAAGAGGCATCACCAA_3	MZ B
TTGATGGAGTATGTAG_3	Monocyte
CTACAGACACTCCACT_3	Monocyte
GACGTTACAGGGAATC_3	Follicular B
ACGGTTATCGGTCTAA_3	MZ B
GAGTGAGCACACCTGG_3	Ery
CGTCAAAAGAACCCGA_3	Plasma cell
GACTCAAAGGGAGATA_3	MZ B
AATCACGGTTCGTACA_3	MZ B
CTCAGGGCATGAATAG_3	Monocyte
CGCCAGAAGAAGCCAC_3	Ery
AGACTCACATGACTGT_3	EC
TAATCTCTCTAGCCTC_3	Monocyte
ATCTCTAAGCTGACTT_3	EC
ACCCTCATCGCCTCTA_3	EC
ATCCTATAGCGTTGTT_3	Monocyte
CAGCACGTCAGAGTGG_3	Monocyte
TTACCGCTCGAGTGAG_3	MZ B
CGATGCGTCCGTGTGG_3	MZ B
GACCTTCTCTTAATCC_3	CD4+ T
CTCAAGACATTGAAAG_3	Follicular B
CAGTTCCTCAAGTTGC_3	Monocyte
GTCATCCGTTCCGCTT_3	Monocyte
CTATAGGGTGGGTATG_3	MZ B
AATTTCCTCCCGAATA_3	Monocyte
TCATATCTCTCACCCA_3	Follicular B
ATCCCTGGTCGAGATG_3	Plasma cell
CCGATGGCACACGCCA_3	Follicular B
ATCGTGATCATCGGGC_3	Monocyte
CTACAGACATGGCTAT_3	Follicular B
AAGACAAGTGAGCTCC_3	MZ B
AGATGAACATGAAGCG_3	MZ B
CTTCCTTAGACATCAA_3	Monocyte
TATTCCATCAGTCTTT_3	MZ B
ATAGGCTCAGTCTTCC_3	EC
TGCGGGTAGCGACATG_3	MZ B
CCATCACCATCCGTTC_3	ILC
GGATGTTGTGTCCTAA_3	Follicular B
CACATGACATCTTTCA_3	Monocyte
CAAAGAACAATACAGA_3	Follicular B
GCATCGGAGTTGTCAC_3	Monocyte
GCTTCACTCTACGCGG_3	MZ B
GCAGGCTAGACTCCGC_3	MZ B
GTAAGTCTCCGATGCG_3	CD8+ T
AAGTCGTAGTACTCGT_3	Monocyte
GGGCTACGTAATGATG_3	MZ B
ACTGATGCATGGCCAC_3	Monocyte
AGATCCATCAGAGCAG_3	Monocyte
CACACAACAAACCGGA_3	CD4+ T
ACCCAAATCGTAACTG_3	MZ B
GTAGTACTCACACCCT_3	Monocyte
GCCGATGAGTTCGGTT_3	MZ B
TGTTCCGAGATCGCTT_3	MZ B
GACCCTTGTTCCAAAC_3	Fibroblast
TGACAGTAGACATCCT_3	EC
GCACATAGTAACATCC_3	Follicular B
TAATTCCGTCGCTTGG_3	Ery
TGGTTAGCAGGCACTC_3	DC1
GAGCCTGGTCCATCTC_3	MZ B
AACCCAATCAGCGCGT_3	Monocyte
GACCGTGAGCATCCTA_3	MZ B
CTATCCGAGGTATCTC_3	MZ B
CATTGTTTCCAATCCC_3	EC
CACACAATCCAACACA_3	CD4+ T
TATACCTAGGTCCTGC_3	MZ B
TGTCCCAAGGGTACGT_3	MZ B
AGACCATGTCGAGCAA_3	MZ B
GGCTTGGGTAACGTTC_3	MZ B
GATTCTTAGATAGGGA_3	MZ B
GTAATCGGTTGATGTC_3	Monocyte
CATGCTCGTCAAATCC_3	Plasma cell
TGAGCATTCGCTTAAG_3	Monocyte
AGGTGTTGTTATTCCT_3	Plasma cell
GCTGCAGTCAAGCCCG_3	Monocyte
CTTGAGAGTGAGGAAA_3	MZ B
TTCATTGGTCAGGTAG_3	Ery
GAGGGATTCTTCCTAA_3	CD4+ T
TCTAACTTCGATGCTA_3	Monocyte
ATCGTGATCCCGTGTT_3	Monocyte
CGTAATGAGATGAACT_3	Monocyte
GTTCCGTGTGCGAGTA_3	MZ B
TCACACCTCCTGTAGA_3	Follicular B
CTGGACGGTTCCGCGA_3	Monocyte
ACTGATGAGCCACCGT_3	Monocyte
TGTCCTGGTCCGAAGA_3	MZ B
AGTAGCTCACTTGAGT_3	Plasma cell
CCACTTGGTAAGACCG_3	Mac
GAAGAATGTGCTGCAC_3	Monocyte
CCCTGATCACAACGCC_3	Ery
TTCCACGTCAGCCTCT_3	Follicular B
ACTGTCCCACCTTCCA_3	EC
GTCAAGTGTGAGACGT_3	Mac
AAGACTCGTGTAACGG_3	Monocyte
GGGAGATCACCCTCTA_3	Follicular B
TATCCTACAATGTCAC_3	Follicular B
GCCCAGACAAGGTCTT_3	Monocyte
CTACCCAGTGACCGAA_3	Monocyte
AGAAGTAGTACTCCGG_3	Monocyte
CATCGCTAGGTTGGTG_3	MZ B
GGGTTATAGCGAATGC_3	MZ B
CTTCAATAGAGACAAG_3	MZ B
CTCTCGAAGTTACTCG_3	Follicular B
GGGACAAAGGCATCTT_3	MZ B
CAAGGGACAGTCGAGA_3	Monocyte
AGATCGTCAGCTCATA_3	MZ B
AAGCGAGAGTTGTACC_3	Monocyte
AGGTCTATCTTAGCAG_3	MZ B
AGTAGCTTCAGTCAGT_3	Monocyte
AGGCCACTCGAACTCA_3	MZ B
AACGTCATCCCAGGCA_3	CD4+ T
CTCTGGTCAGCAAGAC_3	MZ B
TTTGTTGCAGGGAATC_3	Follicular B
TCCGGGACAAGGTCTT_3	Monocyte
CAACCAAGTACACGTT_3	NK
GTCACTCTCAGTCAGT_3	Plasma cell
TGTTTGTCACATACTG_3	Follicular B
CCTGTTGGTCAGTTTG_3	EC
CGGAGAAAGACTCAAA_3	Follicular B
AAAGTCCCATGGCTGC_3	CD4+ T
GCCCGAATCAAACCTG_3	EC
GCTTCACGTGGTTTGT_3	Plasma cell
GAATCACCAAGTATCC_3	Follicular B
GGTTAACAGGTCTTTG_3	Monocyte
TGCTGAAGTACTGACT_3	Ery
TTTGACTTCTCCTGCA_3	Follicular B
CAGCAATCATAGAAAC_3	EC
GTTATGGGTACTCCGG_3	Monocyte
ATGGATCGTACGATCT_3	Follicular B
TCAGTTTCATCCGATA_3	Follicular B
GGAGGTAAGGTAGTCG_3	Follicular B
GTTGTGAAGTAAGGGA_3	Monocyte
CCTCTAGAGCAAATGT_3	Monocyte
ATTCTACGTCAGTTTG_3	MZ B
GTAATGCCAGACGCTC_3	MZ B
TTGGGCGCACTGTTCC_3	Monocyte
GTGTCCTAGGTTAAAC_3	MZ B
TCATCCGGTTAAACCC_3	Monocyte
AAATGGACACAACGAG_3	Follicular B
ATTTCTGAGAGATGCC_3	Follicular B
CCCTTAGCACCCTTAC_3	Monocyte
CGTAAGTTCTTGCGCT_3	MZ B
TCCTCTTCAGAACATA_3	Follicular B
GCATCTCTCCCAACTC_3	Ery
CTTTCGGCAACTTGGT_3	Follicular B
CTTGAGAAGCCTCGTG_3	CD4+ T
AGCTTCCTCCTACCAC_3	CD8+ T
GGGATGACAGTCTGGC_3	CD4+ T
CCCTTAGCAATGCAGG_3	Monocyte
AGTGTTGCACGGTAGA_3	Monocyte
CATCCGTTCGTAACAC_3	MZ B
TGCTTCGGTCTGTTAG_3	MZ B
GGGACAATCTAACGCA_3	Follicular B
GTTCTATGTCAACCTA_3	MZ B
CGTGTCTGTCGCAACC_3	MZ B
TGAGACTAGTCTCCTC_3	EC
CGGAACCTCTCGAACA_3	Monocyte
GACTCAAGTTGCGGCT_3	CD4+ T
GAGTTACAGGCCCACT_3	Monocyte
AGTCAACCATCGTGGC_3	Follicular B
GTTGTGACATAATCCG_3	Follicular B
GTGAGTTCAGTGTATC_3	Monocyte
TCTTAGTGTCCATAGT_3	Monocyte
TGAGGAGAGCTGTCCG_3	Follicular B
GCAGTTACAGAACTTC_3	CD4+ T
AATTCCTCAGAGGCAT_3	Follicular B
AAGCGAGTCGTTAGTG_3	Monocyte
ATTTCTGTCGCAGAGA_3	MZ B
GGAATGGTCCCTCTCC_3	Mac
TGTGAGTTCGTAGCCG_3	MZ B
CAGATACAGTTCCGGC_3	MZ B
CGAGTGCGTTTCACAG_3	CD4+ T
TGTTCCGGTACGGCAA_3	NK
CCTCCTCGTGCTGCAC_3	MZ B
TGAGGTTCAGTGTATC_3	MZ B
CTATAGGGTCATCGCG_3	Monocyte
CGAGTGCGTGTAAACA_3	MZ B
GGGACAAGTATTCCGA_3	Monocyte
GGTTGTAAGCTTTCCC_3	Follicular B
GTTCCGTTCACACGAT_3	NK
AGAGAGCAGAACGCGT_3	MZ B
AATGACCTCCTTGAAG_3	Monocyte
CCGATGGGTAACGATA_3	MZ B
CTGTATTGTAGCACAG_3	MZ B
TGTTACTTCGACGACC_3	CD4+ T
ATCGATGCATGTTCAG_3	Ery
CCGAACGCAAACGGCA_3	MZ B
CACAGGCCAGTCACGC_3	EC
TTGACCCGTCTACACA_3	Follicular B
TTACAGGTCTTACACT_3	MZ B
AAAGGATTCCATAGAC_3	Mac
ATCTTCACAATTGCAC_3	CD4+ T
CCGCAAGCAGAGGCAT_3	Monocyte
GCCTGTTAGCTGTTCA_3	CD8+ T
GTGTGATCACGACAGA_3	CD4+ T
GCTGAATCACGACGAA_3	MZ B
CCTCACATCACGATCA_3	NK
TGAGGAGGTAGTCGTT_3	Ery
TGATCAGCAGCCGGTT_3	Monocyte
ACCATTTTCGGACCAC_3	MZ B
TGCATGACACGACCTG_3	Monocyte
GTGTTAGCACGGATCC_3	MZ B
TCTGGCTCACCGGTCA_3	Follicular B
TGTCCCAAGAGGCTGT_3	EC
CCACGTTTCACAACCA_3	EC
TTCTCTCTCGCGTCGA_3	Monocyte
CTCTCGATCCACCTGT_3	CD4+ T
AGACAGGGTTTGACAC_3	Follicular B
TGCGGCAAGTCAATCC_3	MZ B
TAACACGAGGCCCACT_3	CD4+ T
ACTGCAACAGCGTAGA_3	MZ B
TATATCCGTCACTCGG_3	Monocyte
GTCCCATTCAGTCTTT_3	Monocyte
CCTGTTGTCTCGCTTG_3	Monocyte
ACGTTCCGTGTACAGG_3	Monocyte
GAAGAATTCTGCGATA_3	Follicular B
CTCTCGAGTCCGGATC_3	EC
CTAGGTACACTGCTTC_3	MZ B
ACAAGCTAGAGCCGTA_3	CD8+ T
TGTTCCGGTCGCCTAG_3	Ery
GACTCAAAGTACTCGT_3	EC
TACTTACTCACTCACC_3	CD4+ T
TTGAACGGTGACTATC_3	CD4+ T
GAAGGACAGACAGCTG_3	Monocyte
TAAGTCGCAGCGACCT_3	ILC
GATCAGTTCGTGAGAG_3	MZ B
CTTCGGTGTCCATAGT_3	Monocyte
GCTGCAGGTTGATGTC_3	Follicular B
AGTGTTGAGAAGTCCG_3	MZ B
TCGCACTGTCCCGGTA_3	CD8+ T
CGAATTGAGCCGTTGC_3	Monocyte
AAACGCTGTTGGCTAT_3	Monocyte
GTAGAGGTCTTCTGGC_3	MZ B
GGATCTACAGTCTGGC_3	CD8+ T
CATCCCACAGATACTC_3	EC
GTATTTCTCTCTGCCA_3	CD8+ T
CGGCAGTGTCTAATCG_3	Monocyte
GACTTCCAGTTCCATG_3	Follicular B
CTCCTTTGTCCTGGGT_3	CD8+ T
CTCAGAAGTGACAGCA_3	EC
TCGTAGACATCGAACT_3	Monocyte
CGTGATACAAGACGAC_3	Monocyte
AGTGTTGTCCGTCAAA_3	MZ B
CTCAGAAGTAGACTGG_3	Monocyte
TTTGATCAGGTCATAA_3	MZ B
GTCCCATTCTCCACTG_3	EC
AAGATAGCACACAGCC_3	Monocyte
TGAGGTTGTTCTCGTC_3	MZ B
CAAGACTCACCCAATA_3	EC
CTCAGGGAGGCACTCC_3	Follicular B
GAATAGAGTTATTCCT_3	MZ B
TTAGGGTCAGGCCCTA_3	Plasma cell
TACCTCGAGCATGATA_3	Follicular B
GTTTGGAAGGCACAAC_3	MZ B
GGTTAACGTTAAACAG_3	Monocyte
ACACAGTCATATCTGG_3	Follicular B
CTGCTCAAGCGAACTG_3	Mac
TGAGCGCGTTGCCATA_3	EC
GAGTCATGTGGGAGAG_3	MZ B
ATAGGCTCAATCTGCA_3	NK
CTGTCGTAGGCCTAGA_3	Plasma cell
TCGATTTAGACTTAAG_3	MZ B
GATGAGGGTTACACTG_3	MZ B
CAGTTCCGTGCCTAAT_3	Monocyte
TGCTTGCGTACGATGG_3	Follicular B
TGTTCTAAGTGTTGAA_3	Monocyte
TAATTCCTCTAGACAC_3	Follicular B
GCCCAGACATGACACT_3	Monocyte
TCTTGCGCAGCACACC_3	Monocyte
TCTATCAGTAATTAGG_3	MZ B
GAGGGATTCTGCACCT_3	Monocyte
CTCATTATCGATACTG_3	MZ B
ACGGTCGCAACCCGCA_3	Monocyte
CTAGGTAAGGAGCAAA_3	Follicular B
CTACATTGTCGTTATG_3	Follicular B
ATCGCCTCACAAAGTA_3	CD8+ T
ACTTAGGGTGGCTTAT_3	MZ B
TGGAGAGCAGGTAGTG_3	MZ B
GTCTCACTCATTGTTC_3	CD4+ T
GTTCATTCACTGATTG_3	Follicular B
CTATCTACATTCGATG_3	Monocyte
ATTTACCGTTCACCGG_3	Follicular B
GCTCAAAGTGTTACAC_3	MZ B
GCTTTCGGTAGGAGGG_3	Plasma cell
GAAATGATCCGGCTTT_3	Monocyte
TACTTGTTCGTAACTG_3	Mac
AAATGGACACCTGCAG_3	EC
GATTCTTGTCAACACT_3	Monocyte
TCGACCTGTCGTAATC_3	Follicular B
TTGACCCGTCTGCCTT_3	Monocyte
TCTTTGAAGGGCAACT_3	MZ B
AAGCCATCACCGGCTA_3	Monocyte
ACATGCATCTTCCGTG_3	CD8+ T
ATCACAGCAGTGGCTC_3	Follicular B
GTAGAAATCACAAGGG_3	EC
CTGAATGGTAGAATAC_3	MZ B
ACGTAACGTGACCGTC_3	Monocyte
TTAGGCAAGGTCATTC_3	MZ B
TGCCGAGCATTCCTCG_3	Plasma cell
CGTTAGACATCCCACT_3	Monocyte
TTCTCTCCAACGATTC_3	Monocyte
TGCCGAGGTAACTGCT_3	CD4+ T
TCGCACTAGGTTACCT_3	NK
TACAGGTAGTCGGGAT_3	Monocyte
AAAGTGACAGTGTATC_3	Monocyte
CTGGTCTCATGACAGG_3	CD4+ T
CGATGGCCAAGTGCAG_3	CD8+ T
CGGTCAGTCATGGGAG_3	Plasma cell
TGGCGTGAGCGTGTCC_3	Mac
CCGAACGCAATGGCCC_3	Fibroblast
CTTTCGGGTGCCTACG_3	Monocyte
CCGCAAGAGGTGGGTT_3	Monocyte
TGCAGATTCTACTTCA_3	MZ B
AACGTCAAGCTGTTCA_3	Follicular B
ATCCACCTCCGTGTGG_3	Plasma cell
ATACTTCGTATCCTTT_3	CD4+ T
CTACGGGGTTGTTGCA_3	MZ B
AGATCCAGTGACTGTT_3	MZ B
GCACGTGAGCTACTAC_3	Monocyte
CTCAGAACACGTACTA_3	CD4+ T
TCCGGGATCTAATTCC_3	Follicular B
TCCAGAAGTTTCGTGA_3	Monocyte
CTGGACGGTGTCCAAT_3	Follicular B
ACCACAATCCATCTAT_3	Follicular B
TAACGACTCATGAGGG_3	MZ B
GCGGAAAAGGAATCGC_3	Monocyte
TCCTTCTCATCGTTCC_3	Follicular B
CGTGATACACCAACAT_3	MZ B
CTCCCAATCGACGCGT_3	Ery
AAGACAAGTATGACAA_3	Monocyte
AGATCCATCTATACGG_3	CD4+ T
TCTCAGCTCAACCGAT_3	CD4+ T
CATACTTGTAGACAGC_3	Follicular B
CATACAGGTCATCTAG_3	Follicular B
TCGTGCTGTTGCTTGA_3	MZ B
AGAGCCCGTTCTATCT_3	Monocyte
CTATCCGTCACTCCGT_3	CD8+ T
AGAAGTATCTTCGTGC_3	MZ B
TGGAGAGTCATCGGGC_3	Monocyte
GGTAATCTCAGCAGAG_3	Follicular B
GTGCACGAGCCGATAG_3	Monocyte
CAGTTCCAGATGACAT_3	Follicular B
GAATCGTCATAGGTTC_3	CD8+ T
GTTGCGGCAAGCACAG_3	Monocyte
CCACTTGAGTCCCAGC_3	CD4+ T
GGTTGTATCAGCGCAC_3	MZ B
ACACCAAGTTCCGCGA_3	Follicular B
TGATCTTGTTATAGCC_3	Monocyte
GCACGGTTCCAATCCC_3	NK
TTTGTTGGTGTGAATA_3	Monocyte
TAAGTCGTCCTTTGAT_3	Monocyte
GACGCTGTCCAATCTT_3	CD4+ T
TACATTCCAGGCTCTG_3	Monocyte
GACATCAGTAACCAGG_3	Monocyte
GGGACAATCTGGCCGA_3	EC
CTGCCTAAGCAACTTC_3	Monocyte
GCCAGCAAGCACTGGA_3	MZ B
ATCAGGTAGTTAGTAG_3	Monocyte
GTGGGAAGTGTTGATC_3	Follicular B
GTCCTCAAGTGCAGCA_3	CD8+ T
GGTGTTAGTTCTCTAT_3	CD4+ T
CGGGACTCAGTACTAC_3	Follicular B
CTACATTCATGACGAG_3	Monocyte
CAGATACAGAGTATAC_3	MZ B
TTTGATCTCCCTCGAT_3	Ery
TCGTGCTAGGCTATCT_3	Follicular B
GCTACCTAGTGGTGAC_3	CD8+ T
CGGGTCATCAACGTGT_3	MZ B
ATCGTAGTCCGTCAAA_3	Follicular B
CTCTCAGCACGCCAGT_3	Monocyte
TCATCATAGACGGTTG_3	EC
GATCGTACAATTTCCT_3	Monocyte
CGTGAATCAGTGTGGA_3	Follicular B
TCACTCGAGTAGGGTC_3	MZ B
GTCACTCAGTTCGGTT_3	MZ B
CAGTGCGGTTTCGACA_3	CD4+ T
CCTGTTGTCACCCATC_3	EC
GGCAGTCAGACTTCGT_3	Monocyte
CATTCATTCCGAGAAG_3	EC
CACGTTCCACCCTCTA_3	Follicular B
TATCAGGCACTGTGTA_3	EC
TCAAGTGCATGTAACC_3	MZ B
GTAGATCGTTGCGAAG_3	Monocyte
TACGTCCGTTTGCAGT_3	MZ B
GGTCACGAGCTTCGTA_3	Follicular B
TCCCATGGTGACAGGT_3	Follicular B
GTGGGAACAAAGGCTG_3	MZ B
ACGTACACAAGAAATC_3	CD4+ T
TGGATCAAGCCAGAGT_3	Monocyte
TGTTCATAGCCTGTGC_3	CD4+ T
ATGTCCCTCACCCTGT_3	Follicular B
TATGTTCAGTCATTGC_3	CD4+ T
GTGCTTCTCAAACCCA_3	CD4+ T
TGGGAGACAAGTACCT_3	Monocyte
CCCTCTCCAATCTAGC_3	Monocyte
AAAGGATTCGATTTCT_3	EC
TCCTGCATCTAGCAAC_3	MZ B
TACGCTCCATCATTTC_3	NK
CGAAGTTGTTGGACCC_3	EC
TTCTAACGTTGCCGCA_3	CD4+ T
TGGGCTGTCGGACCAC_3	MZ B
CCATAAGTCCGCCTAT_3	Monocyte
CGCAGGTGTATCGAGG_3	MZ B
GTAGTACCATACAGAA_3	Monocyte
AAACGAACATGCACTA_3	CD4+ T
CTCATGCCAAGTGGAC_3	MZ B
AACCTGACAGCTATTG_3	EC
CTAACTTAGAAAGCGA_3	Follicular B
AGGTTACAGCAATAAC_3	MZ B
TTTACCAGTACAGAGC_3	CD4+ T
GGATGTTCAATTCTCT_3	Follicular B
CCTCTAGTCCAAGGGA_3	Follicular B
TGTGGCGCACATGAAA_3	CD4+ T
GTAGGAGCACAAACGG_3	Ery
GTTAGTGTCACTTATC_3	MZ B
AGCCAATAGTATAGGT_3	MZ B
CTTAGGAAGAGCCATG_3	Plasma cell
TTAGGCATCGCTGTCT_3	Follicular B
TGTTCCGCAATCGCGC_3	Monocyte
GTTATGGTCACGGACC_3	Ery
GCAGTTATCGGTCAGC_3	Follicular B
GGTAATCTCTGACAGT_3	CD8+ T
ATGATCGAGTAGCAAT_3	Ery
GTTATGGCATCGCTCT_3	Monocyte
GGTTGTACAGGCCCTA_3	MZ B
TGTCAGATCTAGCAAC_3	MZ B
TTACGTTCACAGTACT_3	Monocyte
ATGATCGGTCCGACGT_3	Follicular B
TCTCAGCCATGTGCCG_3	NK
GAAGCCCAGTAAGCAT_3	CD4+ T
TCACTATTCGCCACTT_3	Monocyte
ATTCCTACATCCGAAT_3	Mac
AGAGAATCACTGGACC_3	EC
CCTAAGACATCGCTAA_3	CD8+ T
CACAGATGTAATCAAG_3	Follicular B
CATCGCTTCGATTGAC_3	Monocyte
TAGAGTCCATGGTGGA_3	CD8+ T
TTCCTAACATGCACTA_3	EC
TGAGACTGTTAGCTAC_3	Monocyte
ATTGGGTGTAAGGTCG_3	Monocyte
CATCGGGCATTGGCAT_3	EC
TCTATACGTTTGCAGT_3	Follicular B
TCCTAATTCACGGGCT_3	EC
ATCGTCCTCAGCACCG_3	Monocyte
GAAGCGACAAGCGCTC_3	Mac
AATGGCTGTTCCTACC_3	Follicular B
TTCTTGAAGATCACTC_3	Follicular B
TACTGCCAGGAACTCG_3	Monocyte
TGCAGGCTCGTCGACG_3	Follicular B
AGGTTGTAGAAACCCG_3	Mac
AACCAACTCGCTACAA_3	Follicular B
ATGGATCCATGCAGCC_3	CD4+ T
GCCCAGACAAGAAACT_3	Follicular B
CTGAGGCGTCTCAAGT_3	Follicular B
AGACACTAGGATTCAA_3	NK
GGGCCATAGTAAGAGG_3	Monocyte
GTCTACCAGACGTCCC_3	NK
AGAGAATCAGCAGTGA_3	Monocyte
AGAAGCGCAGAAACCG_3	Monocyte
CGACAGCCACTTCTCG_3	CD4+ T
TTAGTCTTCAAGTCTG_3	Mac
CGGAACCTCAACTGGT_3	MZ B
TTCTAACCAGAACGCA_3	Follicular B
TTCAGGAAGCAGGTCA_3	MZ B
CTTACCGAGTATGACA_3	NK
TATATCCGTCGCTTGG_3	EC
GTCGTTCCATTGCAAC_3	Monocyte
TCGCAGGCAGTTAAAG_3	Follicular B
TTGTTGTAGGTACAAT_3	Follicular B
ATGAGGGGTAACATCC_3	CD8+ T
ATCTTCATCTCATGCC_3	Follicular B
GAGATGGTCTTTGATC_3	CD4+ T
TCTAACTTCCATACTT_3	CD4+ T
GGGAGATGTCGTCATA_3	EC
TTGCATTTCGGCCCAA_3	CD8+ T
CTAGGTAAGCTGACAG_3	Monocyte
GGGACAATCATGCCCT_3	Follicular B
CATTGAGCAGTCAGCC_3	CD4+ T
TCGTGCTCAAAGAGTT_3	MZ B
CCCTCAAAGGTCCCTG_3	NK
CCTTCAGAGGCCACTC_3	Follicular B
CAGCGTGCAGGTGTTT_3	MZ B
GACCCAGCAGGTTCGC_3	CD8+ T
CATAGACTCAGCATTG_3	MZ B
TAAGCGTGTAACCCTA_3	Follicular B
GTAGTACAGCCATATC_3	Monocyte
CTTCCGAAGCACACAG_3	Plasma cell
GGGAGTACACTTGAAC_3	EC
TCAGGTACAGACCAGA_3	Monocyte
CGGGTCACAACCGGAA_3	Follicular B
GCCCAGATCCACACCT_3	CD4+ T
GCACTAATCCGTTTCG_3	CD8+ T
TCTTAGTCACTCTAGA_3	NK
GTGAGTTCAAAGCTCT_3	Follicular B
CCGGACAGTCTTCTAT_3	Monocyte
CCGGTAGTCATGCCCT_3	Mac
AACCACATCGGCCTTT_3	CD8+ T
CTGCCATTCCTTCTAA_3	NK
GGGCTACTCTCCAAGA_3	Follicular B
GGCTTTCGTGCCTAAT_3	Monocyte
CATTCCGGTGCGTCGT_3	Monocyte
CCCATTGAGTCCTGCG_3	Follicular B
AAGAACATCAAGGCTT_3	Follicular B
GCCAGGTAGTTCAACC_3	Mac
GTAGATCTCGATACTG_3	Follicular B
TAAGCACGTCTTGCTC_3	CD4+ T
GATGCTATCTCCGTGT_3	Monocyte
GAATAGAGTTGCCAAT_3	Monocyte
GATAGCTTCGGCCCAA_3	Monocyte
GTACAGTCATAGTCAC_3	CD4+ T
AGTCAACTCACTCTTA_3	ILC
TGTTTGTGTCAACACT_3	EC
GGGTCTGTCACCGACG_3	Plasma cell
AAGTACCGTGTGCCTG_3	EC
TCATTGTCAAGACCTT_3	Follicular B
GAACGTTGTATAGGAT_3	CD4+ T
ACAGCCGTCTCAGAAC_3	Monocyte
TATATCCAGTGTAGAT_3	EC
CATGCGGGTTCCATTT_3	NK
CTCTCGAAGTTGTCGT_3	CD4+ T
CATCAAGCACTCGATA_3	Monocyte
TCGATTTTCCGGCAAC_3	CD4+ T
CGCATGGCACGAAAGC_3	ILC
CATGCCTCACTCATAG_3	Follicular B
CACAGGCAGAGTCAGC_3	EC
TATGTTCCACCTAAAC_3	Follicular B
GTGATGTAGCAGTCTT_3	MZ B
TAGATCGGTTTGAAAG_3	Follicular B
TCGACGGTCCTGTAAG_3	Follicular B
ACTATCTGTGGACCTC_3	CD4+ T
GTGATGTGTCTTCAAG_3	MZ B
AAGGTAAGTGTGAATA_3	Mac
TGAGCATAGGTACTGG_3	CD4+ T
AGGTCATTCTGTTGGA_3	MZ B
AGAAGTATCTGGCCGA_3	Follicular B
AGCGCCATCAACACGT_3	Monocyte
TGTTCTAAGGCTTTCA_3	Follicular B
CTGTCGTCATCTTCGC_3	Monocyte
GATGCTATCGACGTCG_3	Monocyte
GGGTGTCGTATCCCAA_3	Follicular B
CTCAGTCCAACGTATC_3	ILC
TTTACCACAATAGGAT_3	CD4+ T
TACAACGGTTCACCGG_3	CD8+ T
CTACTATGTCGGATTT_3	EC
ACCCTCAGTTCGGTCG_3	Plasma cell
TCTGTCGGTTTGACAC_3	Follicular B
CGTTGGGAGCTATCTG_3	Monocyte
AGATGAAAGAGTCTGG_3	CD8+ T
AGCCAATAGGTATCTC_3	Follicular B
GAACACTGTGTCATGT_3	Monocyte
GTGAGCCGTTGCATGT_3	CD8+ T
GATGTTGCATCCTTGC_3	CD8+ T
CCATAAGCATGGCCCA_3	Follicular B
TACCCGTCACAATCTG_3	CD8+ T
GGGACAAAGACCGCCT_3	Follicular B
AATCGTGCAAGCCATT_3	NK
GCACATAAGGCATCTT_3	Monocyte
TCAGGTATCTACCAGA_3	CD4+ T
ATCACGATCTCTGAGA_3	CD4+ T
GGCAGTCGTATCGAAA_3	CD8+ T
CTGATCCGTGATTAGA_3	Follicular B
CCTCATGAGACCTGGA_3	MZ B
CATGCCTCACTACTTT_3	Follicular B
GCTCAAATCCAACTGA_3	Follicular B
GAAGAATCAAGAATAC_3	CD8+ T
CTGGCAGTCAGCTTGA_3	ILC
GTGCAGCAGTCACTCA_3	CD8+ T
TCCACCACAGAACTAA_3	CD8+ T
GTCTTTAAGTCACTGT_3	CD8+ T
GTCCCATTCCTTCTTC_3	EC
CTGGACGTCGAACTCA_3	CD4+ T
GGAGATGGTAGTCCTA_3	Monocyte
CTCCGATTCGGTCGAC_3	MZ B
CCTCACATCTGGGCGT_3	CD8+ T
AGTCAACCAAGCGGAT_3	EC
ACAAAGAGTGCCTGCA_3	Monocyte
ACTTATCCAACTTGCA_3	CD8+ T
ACTGTCCCATTCAGGT_3	MZ B
CTCAGTCAGAACCCGA_3	CD4+ T
ACGGAAGTCGGTGTAT_3	CD8+ T
GTTAGACCAACTGCCG_3	CD8+ T
GAGGGATCACATGAAA_3	Monocyte
CGGCAGTCACCTCTGT_3	Follicular B
TCACTCGCAGGTTCAT_3	Follicular B
GCATCGGGTCCTTAAG_3	Follicular B
AACAAGATCTCTTAAC_3	Follicular B
AGGTAGGCACCAAAGG_3	Monocyte
TGTCCACAGAAGCTCG_3	CD4+ T
AGTAGCTTCACGGTCG_3	Follicular B
CATTGTTTCTGATGGT_3	CD8+ T
GTTCATTTCCACAGCG_3	CD4+ T
GAAGCGACAAGAGTGC_3	CD4+ T
AGCATCAAGCCTCTGG_3	Follicular B
CATTGTTTCGTAACTG_3	CD4+ T
GTAACACTCACTGCTC_3	CD4+ T
CTCATTATCTTTCGAT_3	NK
AGGCATTCAACGGGTA_3	Monocyte
TTTGGAGAGGATTTAG_3	CD4+ T
CGCCAGAGTACCATAC_3	NK
GTAATGCGTTACACTG_3	NK
GGACGTCGTGATAGAT_3	Follicular B
CTTGATTTCCAAGCAT_3	NK
AAAGGTATCCCGAGAC_3	CD4+ T
CTATCTATCTGGTCAA_3	NK
GTGGCGTTCCCGAGTG_3	Monocyte
AGCATCAAGGGTTGCA_3	CD8+ T
TACTGCCGTTCAAACC_3	Monocyte
CCCAACTCAGCTTCGG_3	CD4+ T
CCCATTGCATAGACTC_3	Follicular B
CTCAGTCCACTCTCGT_3	EC
GCAACCGCACATAGCT_3	CD8+ T
TTAGGCACACTCCGGA_3	Follicular B
CGAGTTAGTTCCTTGC_3	CD8+ T
ACCTACCGTAGGCAAC_3	CD4+ T
GCTACCTTCCACCTCA_3	Follicular B
TTCTCTCGTTGTGCAT_3	CD4+ T
CCGATGGTCGTCAGAT_3	NK
TGGATCATCCTAACAG_3	Follicular B
TCATACTGTCTGTCCT_3	NK
TCACTCGAGCTCACTA_3	CD8+ T
TTACGCCCAGCATTGT_3	NK
GTAGCTATCGCCATAA_3	NK
AGTGCCGCACTCGATA_3	Mac
GTCACGGGTTGCCAAT_3	CD8+ T
AGGAGGTCATCTTAGG_3	CD8+ T
CTAACCCGTTTGGAAA_3	Monocyte
TAAGTCGGTGATGTAA_3	CD8+ T
TTGTTTGTCAAGGAGC_3	Monocyte
CTGTAGACAATTCACG_3	CD4+ T
TTTGGTTGTGTACGCC_3	CD4+ T
GTGGGAACAGCCCACA_3	Follicular B
CTTCGGTGTTGGAGAC_3	CD8+ T
GTCAGCGTCATTTACC_3	MZ B
TCCATCGGTCAGTTTG_3	Follicular B
GCTTGGGTCAGGCGAA_3	CD8+ T
GATAGAACAGAGTGTG_3	CD4+ T
TCGACGGTCGTAACTG_3	CD4+ T
ACAACCAGTATGAAAC_3	Follicular B
AGGCATTGTATGGTTC_3	CD8+ T
ATCGTCCAGCCTATCA_3	Monocyte
AAGTTCGAGACATATG_3	Plasma cell
ATGGTTGAGATGCTGG_3	MZ B
CATCGGGAGTATAACG_3	Plasma cell
TGACCCTAGTGGACTG_3	NK
CAAGACTCACCAAAGG_3	Monocyte
TCCTAATCACGTTGGC_3	CD8+ T
GCACATACAGAAGTGC_3	Follicular B
GGTTGTACAACCTATG_3	Follicular B
ACACCAATCCGTATAG_3	MZ B
AACAACCCATTGGCAT_3	CD8+ T
GATCACAGTGTTTCTT_3	CD4+ T
GTTGTCCTCTCCAAGA_3	CD8+ T
GGGCCATGTCCCTAAA_3	CD4+ T
ACACTGAGTTATCTTC_3	CD4+ T
AGACAAATCGAACGGA_3	Follicular B
CCACAAATCGCGGACT_3	CD4+ T
TTCCTCTTCACTACTT_3	CD8+ T
ACCCAAAGTTACCTGA_3	CD8+ T
ACTTAGGTCGAGAGCA_3	MZ B
GATGACTCAACAAGTA_3	Plasma cell
TACTGCCAGGCCATAG_3	Monocyte
GCTGCAGAGAGCTTTC_3	Mac
TTGTTTGGTTCTGACA_3	Fibroblast
TTGCCTGAGCGAGTCA_3	CD4+ T
AATCACGTCATCGTAG_3	NK
ATCCGTCCACAAGCTT_3	Mac
ATCACGAGTCCTGGTG_3	NK
ACCATTTGTGGTTTGT_3	Monocyte
GAGGCAATCCGTCCTA_3	EC
TAGAGTCTCCAAGCTA_3	CD4+ T
CGCGTGAGTGTACGCC_3	Follicular B
TACTGCCCACTCCTGT_3	Follicular B
CACTGAAAGTAGCATA_3	CD4+ T
TAACGACTCCAGTACA_3	NK
TCATTTGCACGCACCA_3	CD4+ T
TCTTCCTGTTTCCCAC_3	Follicular B
AAGTTCGAGGAACGAA_3	EC
ATTCCTACAGAATGTA_3	Follicular B
TAGCACACACCCTATC_3	EC
CCTATCGCATGGGTCC_3	Follicular B
TTTACCAGTGGAGAAA_3	Follicular B
ATTTCACCAAGTGATA_3	EC
GCATCGGCACTAAACC_3	CD8+ T
GCCATTCAGCATGCGA_3	CD4+ T
TGTGTGACAAGTCATC_3	Follicular B
AGGCTGCCATAATGCC_3	NK
TTGCCTGTCTTCGACC_3	NK
GAATCGTGTTTACTTC_3	Monocyte
TCTAACTGTCAAATCC_3	Monocyte
TCCGGGAAGAAACTAC_3	CD4+ T
AGACTCAGTTATAGCC_3	CD4+ T
AGCGCTGCATCCCGTT_3	CD4+ T
CGAGGAATCTAGTCAG_3	Monocyte
AGAAATGTCCTAGAGT_3	CD4+ T
AGGGTGATCTAGCCAA_3	Monocyte
ACCATTTAGCCTGTCG_3	CD8+ T
CCTTCAGCAAGTAGTA_3	Follicular B
TTCTCTCTCGTCGCTT_3	NK
AGCTACAAGCGATGGT_3	EC
TATGTTCCATTGAAAG_3	Follicular B
ATCACTTGTCGATTTG_3	Follicular B
ATCGTGACAACGTAAA_3	CD8+ T
CTTTCAATCACAAGGG_3	CD4+ T
ACTTTGTAGATCACCT_3	Mac
TCACTATCAGAAATTG_3	EC
GTAGGAGCACCAGTAT_3	Monocyte
GCGATCGCAGTAGAAT_3	NK
GTACAACGTGACACGA_3	Follicular B
CGCCATTAGGTTACAA_3	MZ B
TACCTGCGTATTTCTC_3	CD8+ T
CGATGCGTCTCCGTGT_3	Follicular B
CCTCAGTTCGTTGTAG_3	Monocyte
AGCCAATTCGAGAACG_3	Mac
GAGTCATTCTCCATAT_3	Follicular B
CAACCTCAGGTCGAGT_3	CD8+ T
AGATGAAGTGCAAGAC_3	NK
TCACAAGTCTCTGAGA_3	NK
TATTTCGAGTAGTCCT_3	CD8+ T
GCCAGCAAGAGCCTGA_3	Follicular B
ACTATGGGTGCTATTG_3	Follicular B
GGAGAACCATCATGAC_3	CD8+ T
ATTCCATCATCTCATT_3	CD4+ T
ATGCCTCTCCACCCTA_3	Follicular B
GATGTTGCACAAAGTA_3	Mac
ATCGTAGAGAACCCGA_3	CD8+ T
ACTTCCGAGCGTGAGT_3	CD4+ T
TGCGGGTTCAAACGAA_3	NK
CACCAAATCCCATAGA_3	EC
CATACCCAGTTGCTGT_3	CD4+ T
AGGACGAAGGTATCTC_3	NK
GGCAGTCAGAGTCACG_3	NK
GCATGATCAGACGCTC_3	CD4+ T
TCTTAGTAGTGCGACA_3	CD4+ T
AAAGTGACACGACGAA_3	NK
AAGCGAGTCTCATAGG_3	Monocyte
ACCTACCGTGCATCTA_3	NK
TTTCCTCCACAACGAG_3	Monocyte
CAGCAGCAGCTGTCCG_3	CD8+ T
AACAAAGAGTGCGCTC_3	NK
ATAGGCTTCAAAGACA_3	CD8+ T
CACTTCGTCTCGCTCA_3	CD8+ T
CATCCGTCACGTATAC_3	NK
CGCATGGTCTCGTTTA_3	NK
GAATAGACAGTTGTCA_3	Monocyte
CATTCCGGTACGAGCA_3	Monocyte
GAGTTTGTCGAAGTGG_3	Monocyte
GATCGTACAACAAGAT_3	Ery
GTAGAAAGTGCCCTTT_3	EC
TACCCGTAGTTCTCTT_3	NK
TTACGCCTCTTCGACC_3	Follicular B
ACTACGACAACGAGGT_3	CD8+ T
CCGGTGAAGGTCGCCT_3	CD4+ T
CGTAATGCATCTTAGG_3	CD4+ T
TGCCGAGAGCACTCGC_3	Ery
TTGTTGTTCGATGCAT_3	CD4+ T
TACCTGCCACCATTCC_3	Follicular B
ATCGGATAGCATCAGG_3	Follicular B
CTATCCGCAATGGGTG_3	ILC
TGTGATGAGAAACCCG_3	Follicular B
CCTCAACTCGACATTG_3	CD4+ T
CAGCACGGTACAGTCT_3	Monocyte
ATGAGTCAGCACCTGC_3	CD4+ T
TAGGTTGTCACGATCA_3	CD4+ T
TCATGCCTCGAATCCA_3	CD8+ T
TTACGCCTCTCCACTG_3	NK
TCTGGCTGTTAGGGTG_3	CD4+ T
TCTTAGTCATTCAGCA_3	Follicular B
CTGCGAGCAGTAACGG_3	Monocyte
AGGACTTTCCAGTTCC_3	Follicular B
GCCAACGTCAATCTCT_3	Follicular B
TGCTCCAGTCACCACG_3	CD8+ T
AGGTCTAAGAATTTGG_3	CD8+ T
CTTTCAAAGATCCTAC_3	CD4+ T
TGGGCGTTCCTTGGAA_3	EC
GATTGGTCAGCGTACC_3	CD4+ T
CCGGGTAAGCTGACAG_3	EC
TAGGTACAGCATATGA_3	Mac
GTCACTCTCAACTACG_3	Monocyte
AACCTGATCACCTACC_3	Monocyte
GATAGCTGTAGTGTGG_3	NK
TTACTGTAGGTCTACT_3	EC
TTGCGTCTCCAATCCC_3	CD8+ T
CTGATCCCATAGTCAC_3	NK
GTCAAACTCTATACGG_3	Ery
TACCCGTGTGAGTAAT_3	CD4+ T
TCTACCGTCCACAAGT_3	NK
ACTCCCAAGAGAACCC_3	CD8+ T
CACACAAGTCAACACT_3	CD8+ T
TTCCGTGTCCGACAGC_3	MZ B
CCGGTAGTCTCAACGA_3	CD4+ T
TCTTGCGCAGAACTTC_3	Monocyte
GAGAAATGTCTTTCAT_3	CD8+ T
CCGAACGGTTCCAAAC_3	CD8+ T
GCTTTCGCAAGGCTTT_3	Follicular B
GTGAGGAAGAATCGAT_3	Follicular B
AGATAGAAGGGACTGT_3	NK
AGAAATGGTCTGTGAT_3	Monocyte
TTCCTCTCACATGGTT_3	CD8+ T
CTAGGTACAGTGGTGA_3	Plasmablast
TTTATGCCAAGCGAAC_3	Follicular B
TGTCCTGCATAATGCC_3	Follicular B
CGAGTGCCACGTCTCT_3	CD8+ T
TGTGTGACAAATAAGC_3	CD8+ T
ATTACTCTCGAATGCT_3	NK
TGATTCTCAGAGCTAG_3	NK
TAGACCACAATTGCAC_3	NK
TGCTGAAAGTTGTACC_3	NK
TCAAGACCATTGACTG_3	Follicular B
GTTAGACGTCTTAGTG_3	EC
AACGTCAAGATGGCAC_3	EC
TGTACAGCAATACGAA_3	CD8+ T
CACTGGGAGAAAGCGA_3	Monocyte
ATGCATGAGCGGTAGT_3	CD8+ T
TACTGCCGTCCCTCAT_3	CD8+ T
TGGAACTTCGGCGATC_3	CD4+ T
TGCTGAATCCCATAAG_3	CD8+ T
TGGTGATTCGACGATT_3	Follicular B
GGCTTGGGTAGTCCTA_3	ILC
TGACAGTGTTGCGAAG_3	Monocyte
GCCAGGTAGCATGATA_3	CD8+ T
TGTGTGATCTTCCTAA_3	NK
GCTTCACTCATTTACC_3	NK
GCGGAAAAGCTGACCC_3	Follicular B
CCTCACAGTTGAGTCT_3	CD8+ T
TTCGCTGCATAACTCG_3	NK
CCTCTCCCACAACCGC_3	CD8+ T
CACCAAATCATGCATG_3	CD4+ T
ACTATTCAGCGTGTCC_3	Plasma cell
AGGGAGTGTCTAACTG_3	CD4+ T
AATCACGCACTCAAGT_3	Monocyte
CAGTGCGTCCTACGAA_3	Follicular B
CTACGGGAGTAAATGC_3	NK
GTCGTTCAGAAACCAT_3	Follicular B
ACGATCACATTGTCGA_3	Follicular B
ATCAGGTCATAAGATG_3	CD8+ T
CATTCTATCTCAACCC_3	Monocyte
GGAAGTGGTAGACAGC_3	Follicular B
CCTCAACTCATAGACC_3	Follicular B
GTCATGAGTCAAGCGA_3	EC
TATTCCATCTGCTAGA_3	NK
ACGGGTCTCGAGTCTA_3	NK
CAACCTCCACAAGCCC_3	Follicular B
TTTCCTCTCACTGTCC_3	CD8+ T
TCCCAGTAGAATCGAT_3	Follicular B
GCACGTGAGCCTATCA_3	Follicular B
ACTACGACATAAGCAA_3	NK
TACAACGCATCGCCTT_3	NK
TGGGCTGGTACGTACT_3	Follicular B
GGATCTAGTCCGGCAT_3	Monocyte
TATCAGGGTTCCTAGA_3	NK
AATGAAGAGCCTTGAT_3	Follicular B
TACCTCGGTACGCTAT_3	CD8+ T
AAGATAGGTGCGTCGT_3	Follicular B
AGAACAATCAAGGTGG_3	MZ B
CTGCCTAGTCTGTCCT_3	CD8+ T
TCTATCACACGGGTAA_3	CD4+ T
AGATGAACACAACATC_3	Follicular B
TCTTGCGCAAATAAGC_3	CD8+ T
CTCCCAATCATCAGTG_3	CD8+ T
TCCGATCGTTCGCGTG_3	MZ B
GAGATGGTCTCGTGAA_3	NK
TTCCACGGTTCTGAGT_3	NK
CATTCTATCTTGATTC_3	CD8+ T
CATAGACGTACGTAGG_3	Plasma cell
TACGGGCAGCTCACTA_3	NK
TCGATTTTCAGCTGTA_3	Follicular B
TTCGCTGTCCTTATAC_3	CD4+ T
CTGTACCCATCGCTAA_3	CD8+ T
ATTACCTCAGCCGTCA_3	CD8+ T
TGTTGAGAGTCTGTAC_3	CD4+ T
TCCACCATCATGGTAC_3	CD4+ T
CGAGAAGGTAGATTAG_3	CD8+ T
CATAAGCCAGAACTCT_3	CD8+ T
TCACAAGTCCATTTGT_3	NK
AAAGTCCTCTGTCAGA_3	CD4+ T
CTTCCGAAGTAACGTA_3	Follicular B
CATAGACGTTCTTGCC_3	CD8+ T
CAAAGAACATATGAAG_3	CD4+ T
GACTTCCCATCGAAGG_3	Follicular B
GATTCTTGTCGAAGCA_3	CD8+ T
TTGCATTCAATGGCCC_3	CD4+ T
CTCCAACCAGGTTCCG_3	NK
AGTGATCAGTAGAATC_3	Monocyte
CGAGGAAGTCTACATG_3	NK
ATTCCATAGCTACTGT_3	CD8+ T
TATGTTCTCGACGTCG_3	DC1
CTTAGGAAGGCCTTCG_3	NK
AGTACCAAGGTGCGAT_3	CD4+ T
CGAATTGAGCATCTTG_3	NK
GGGAGATGTGGCACTC_3	CD8+ T
CTGTGAATCAATCAGC_3	Ery
CACGAATCAACCTAAC_3	NK
AGACACTAGTCCTGCG_3	CD8+ T
CCACTTGCACCACTGG_3	CD4+ T
CACCGTTGTCCCTAAA_3	NK
CATCGCTGTTGTGTTG_3	Monocyte
CACTAAGGTGGAAGTC_3	CD8+ T
GCCAGGTGTGCATCTA_3	CD4+ T
AATGGAATCCCTTTGG_3	NK
CCACGTTAGCCTGTCG_3	Follicular B
AGATGAAAGTTCAACC_3	Follicular B
TTCCAATGTCGTCATA_3	Follicular B
GATCAGTTCTCCCAAC_3	Follicular B
ACGATGTAGTATGACA_3	CD4+ T
GTGTCCTCACAGTACT_3	CD4+ T
ATCAGGTAGAAATGGG_3	Ery
TCCTTCTCAATTGTGC_3	Follicular B
CTCAGTCCATGTGGTT_3	Follicular B
GAAACCTGTACTCGCG_3	NK
TCATACTAGTGTTCAC_3	NK
ACGGAAGGTCTTACTT_3	Monocyte
TTCCACGTCTGTAACG_3	Follicular B
CCGTTCAAGTGCCGAA_3	MZ B
CACCAAATCCTTCTTC_3	Follicular B
GTCACTCAGAGCTGCA_3	CD8+ T
TGTGCGGGTTGCCGAC_3	Follicular B
GTTAGACTCATGGATC_3	Follicular B
CGGCAGTAGTTAACAG_3	Monocyte
CTTCGGTGTAGGGAGG_3	CD8+ T
GGGTGTCTCGGAGATG_3	ILC
TCATTTGGTAGCGCCT_3	CD8+ T
TTCATTGTCGACGATT_3	CD8+ T
CGAGGCTGTCGCCACA_3	NK
TCCCACAGTGTCACAT_3	CD8+ T
GGCAGTCCACCACTGG_3	NK
ACTTCGCGTAGAGACC_3	MZ B
CCTAACCTCGCACGGT_3	Follicular B
ATGCGATCAAGGGTCA_3	Monocyte
CAATTTCAGCCATATC_3	CD8+ T
TTTCGATAGGTAGCAC_3	MZ B
CAACGGCAGTAGGCCA_3	NK
GCCCAGAAGGGTTTCT_3	NK
TCATTTGGTTCAAGTC_3	CD4+ T
GATGACTGTCTAGGCC_3	Follicular B
ACCCTTGTCGAAGTGG_3	CD8+ T
TTTCCTCAGTGGTGGT_3	CD4+ T
TTACCGCTCAGCTTGA_3	Monocyte
ATTGTTCAGAAGCGAA_3	Monocyte
TATACCTCATCCGATA_3	Monocyte
TTGTGTTAGATACGAT_3	Follicular B
ACGTTCCAGGCTGGAT_3	DC2
TCATGCCTCGAAACAA_3	CD4+ T
GTCACGGCATGGTACT_3	NK
GTAGAGGCATAGGAGC_3	Monocyte
CCTGTTGAGCATAGGC_3	Plasma cell
CAAGCTACACAGTATC_3	CD8+ T
TACTTGTCAATCTGCA_3	NK
GCATCTCAGTGGACTG_3	CD4+ T
GCGTGCAAGTTACTCG_3	CD4+ T
GAGTTTGGTCGCATTA_3	Follicular B
AACAAGACACGACCTG_3	NK
TCGCACTCATGAGATA_3	CD4+ T
CATCAAGGTGGAGGTT_3	CD4+ T
TGTCCCATCCGTAGTA_3	CD8+ T
CTTTCAAGTGTCCACG_3	NK
TAAGCACTCCCGTGTT_3	NK
AGCGCTGAGCAGGCAT_3	Follicular B
ATTCCTATCAATCGGT_3	Follicular B
CATGGTACAAGTACCT_3	CD4+ T
TCACTCGTCGACTCCT_3	NK
TTGTTCATCAACTGGT_3	CD4+ T
GTGCGTGGTACGTAGG_3	CD8+ T
CCCGGAAGTGGCTTAT_3	Monocyte
ATGGGAGCAGTGTATC_3	Follicular B
CATACTTGTCAGGAGT_3	CD4+ T
GAGCCTGCACCTGAAT_3	CD4+ T
TCCATCGTCATTTGCT_3	CD8+ T
AACAACCTCTGGGCCA_3	Follicular B
CTACAGAAGCTGACAG_3	NK
GAAGTAACAATAGTGA_3	CD4+ T
TCCTCTTTCCGTAGGC_3	Follicular B
TCCGGGAGTCCTCATC_3	CD4+ T
TGTGTGAAGGCTCTCG_3	Monocyte
CTGATCCAGGTCGACA_3	CD4+ T
GTGTGGCCAGCGACCT_3	Monocyte
GCAACCGTCTTGAGCA_3	Follicular B
AGTCAACTCCGAACGC_3	NK
GAGGCCTGTCGAGCAA_3	CD4+ T
GGAGGATGTTCCAAAC_3	Follicular B
AGTTAGCTCTTAAGGC_3	NK
TGGTACAAGGAGAGGC_3	Mac
TAGATCGTCCTTTAGT_3	CD8+ T
AGATCGTAGTGATAAC_3	NK
TTATTGCAGGTAGACC_3	Mac
ACTACGAAGTCGTCTA_3	Mac
TCCAGAACATGCCATA_3	Follicular B
TGGGAGAGTGAGAACC_3	EC
CAACAGTGTGGTCAAG_3	Ery
AGATAGATCCGAGTGC_3	NK
TCTTGCGCAAATGGAT_3	Mac
GAGTTTGGTTATAGCC_3	Mac
ATTCGTTTCGCCAATA_3	NK
CTTCGGTCAACAGCTT_3	Plasma cell
TGAGACTCAGTCAGTT_3	CD8+ T
CAATACGCACGAGAAC_3	Follicular B
GTAGATCGTGTGAGCA_3	Follicular B
GAGTTTGAGAAACTCA_3	CD8+ T
CTGGCAGGTATGTCTG_3	Follicular B
TATCTGTTCCGAGGCT_3	NK
TTCACCGAGAGCAGTC_3	CD8+ T
CTGTAGACAACACGTT_3	CD4+ T
CGGGTCATCGTTGTGA_3	Follicular B
GGGTAGAAGGCGTTAG_3	Follicular B
TTCACCGAGCCTTGAT_3	Monocyte
AGGTGTTGTCGGTACC_3	Monocyte
CTGCATCTCATGTCTT_3	CD8+ T
ACAAAGATCTTAATCC_3	NK
GAGGCAACATGCAGCC_3	NK
CTGTCGTTCTGACAGT_3	MZ B
CTCTGGTCACTGTGAT_3	CD4+ T
ACAGGGATCCCAACTC_3	CD8+ T
TCCTCCCTCTGTAACG_3	NK
TTGTTCAGTTCGGTAT_3	NK
TATCTGTAGAACGCGT_3	EC
CTGCAGGGTCAAATCC_3	CD4+ T
GATAGCTGTCGCTTAA_3	Monocyte
TACCTGCGTCGAACAG_3	NK
AGCATCATCAGCTTGA_3	CD4+ T
GTATTTCAGGTCCGAA_3	MZ B
AGCGATTAGCCGGATA_3	NK
GTCTGTCTCTGATTCT_3	Mac
TGCTGAAAGCTTCTAG_3	NK
ACTATTCCAAGGACAC_3	Follicular B
AGACCCGTCACTACGA_3	EC
ATGGTTGTCGGAGATG_3	CD8+ T
GTAGATCCATTCAGGT_3	Follicular B
TGGTACACACTAGTAC_3	CD4+ T
TGGATCAGTGCCGTTG_3	EC
GTCAAACAGTTGGCTT_3	Monocyte
CAGGTATGTGCACGCT_3	MZ B
GACCCTTGTCGAAGCA_3	NK
GAATAGATCATGCCCT_3	MZ B
GTTGCGGCAGGATGAC_3	NK
TGCACGGGTAGACACG_3	NK
ATGGAGGTCAAACTGC_3	CD8+ T
TAATTCCAGCTGAGCA_3	NK
TGAGACTTCTCACGAA_3	NK
TATACCTTCAAGCCAT_3	CD4+ T
CTTTCAAAGTGGAATT_3	NK
ATTCCCGGTAAGGCTG_3	Mac
GAGGCAACAAGAAACT_3	NK
GTCACTCAGCAGTCTT_3	CD4+ T
GGGATGATCACGTAGT_3	Monocyte
AGCTCAATCGATCCCT_3	CD4+ T
CTGGCAGGTCGGAAAC_3	NK
AGGGTGACAGCATACT_3	NK
GCGGATCCAGAATTCC_3	CD4+ T
AGGATAAGTAGTCGGA_3	NK
TGTCAGAAGGCTGAAC_3	CD4+ T
TAACACGCACGTACTA_3	MZ B
CACGTTCTCCTGGTCT_3	CD8+ T
CAGGTATAGGACGCTA_3	CD8+ T
CTGGACGTCGCGTTTC_3	Follicular B
GCTGGGTTCTAGCATG_3	CD8+ T
GAGTTACTCTTCGACC_3	CD8+ T
CGACAGCCATATCGGT_3	Follicular B
ACTGTGATCAATGCAC_3	NK
CACACAAAGAAGCTGC_3	NK
GAGCTGCTCGCGTTTC_3	CD8+ T
TTGAGTGCAGATCCAT_3	Follicular B
CTATCCGCATACTTTC_3	Follicular B
AGCGATTCAATTGGTC_3	CD8+ T
TGTGAGTCAGATTCGT_3	Monocyte
GTGGTTATCCAAATGC_3	CD4+ T
GTTGTAGAGTTTAGGA_3	CD8+ T
TCGGGTGAGGAACGCT_3	EC
GGGTCTGAGTACAGCG_3	Follicular B
GTCTTTAAGAGCATAT_3	CD4+ T
AGGACGAAGCTACTGT_3	CD8+ T
CTTACCGTCTCGTTTA_3	Ery
AATTCCTTCTGGTTGA_3	CD4+ T
AAGACAAGTTAATGAG_3	CD8+ T
GTCTCACAGCGCCGTT_3	NK
TCTGCCAAGTAGTGCG_3	Follicular B
CTGAATGTCGCGGACT_3	EC
TCCTTTCAGGCTCACC_3	CD8+ T
GACGTTAAGGAAGTAG_3	Follicular B
AGCCACGTCGTTCCCA_3	CD8+ T
GCCGTGAGTTATGTCG_3	Follicular B
TAGGTACTCTGTCAGA_3	Monocyte
CATTCTAAGCACCGTC_3	Follicular B
AGGAGGTTCCTATTGT_3	CD8+ T
ATTATCCAGCCAAGGT_3	Mac
GAGTGTTGTAGGGAGG_3	CD4+ T
ATGCATGGTCTACAGT_3	CD4+ T
ACGTACAAGCCTTCTC_3	Monocyte
AGACCATGTGGACCTC_3	Follicular B
GCATGATCAGTACTAC_3	EC
GACGCTGAGCCGGAAT_3	NK
CTATAGGGTTGCTCAA_3	CD4+ T
CTTGATTAGGTCCTGC_3	Plasma cell
ACGTTCCCAAACTAGA_3	NK
GCATTAGAGAAGATCT_3	EC
CAGAGCCAGGTGGCTA_3	Monocyte
AAGTCGTTCGTGCATA_3	Monocyte
TTCTTGACAAGCGAAC_3	CD8+ T
TGTTACTCATTACGGT_3	NK
CAAAGAAGTTGAGGAC_3	CD4+ T
CATTTCAGTATCAAGA_3	CD8+ T
CTTCCTTGTGAACGGT_3	CD8+ T
TGTAACGGTCTGTCCT_3	EC
CCACGTTAGGGTCAAC_3	CD8+ T
TCGAACATCCCTCATG_3	Plasma cell
GTGGTTAAGCAAGTGC_3	CD8+ T
GACTTCCAGAGCCATG_3	Follicular B
ATGGGAGAGGTGCAGT_3	Monocyte
TTGTGGAAGCGAGAAA_3	CD8+ T
TTTGGAGCAGTCGGTC_3	Plasma cell
ATCACAGGTCAGGTAG_3	CD8+ T
CAATGACAGTCCGTCG_3	CD4+ T
AGGTCATGTGCTATTG_3	NK
TCGCTCATCGAATGCT_3	Follicular B
GTAGGTTGTAAGCGGT_3	CD8+ T
CTCATCGTCTGGGCCA_3	NK
ATGCGATTCTCTGCCA_3	CD8+ T
ACCTACCGTACCTAGT_3	NK
TTAGGCAAGCGCACAA_3	Monocyte
TTTCGATGTAAGTTAG_3	Monocyte
CGTAATGAGTTGGGAC_3	NK
TATTGCTGTGATGAAT_3	NK
ATCCCTGTCCTACGAA_3	Follicular B
TTTACGTAGGCCTAAG_3	NK
GATTGGTCAACAGATA_3	NK
GCACTAAAGAGATTCA_3	CD8+ T
CCGTAGGTCGCTTGAA_3	Follicular B
GAGACTTTCTGTTGGA_3	CD8+ T
CTCGAGGGTTCGGTAT_3	CD8+ T
AGATGCTGTATTTCTC_3	Follicular B
AAAGAACCAATCCTAG_3	Follicular B
ACATCGAAGTAGTCAA_3	Mac
CAGCGTGGTCACTCGG_3	CD4+ T
TTCTAACGTTGAGTCT_3	NK
CCTCTCCGTCCTGTCT_3	Follicular B
TTCGATTGTCGAGTGA_3	CD8+ T
AGAGCCCTCAGGAAGC_3	Monocyte
GTGGCGTGTACAGCGA_3	Follicular B
TACACCCGTCTACAGT_3	Monocyte
TAAGCACCATGTTTGG_3	NK
TAAGTCGAGCTGAAAT_3	CD8+ T
TCAAGCAGTAGAGCTG_3	Mac
TCCATGCAGTATAGGT_3	CD8+ T
CGGGACTCAACAGCTT_3	CD8+ T
GCCAACGTCTACACAG_3	CD8+ T
CTTCAATCAACATCGT_3	NK
GTGTCCTTCGACATAC_3	NK
CCCATTGAGCTGACTT_3	NK
CTACTATGTGTATTCG_3	NK
GACCCTTGTCACTTCC_3	NK
CTAGGTAGTTCGAACT_3	DC2
TGAGTCAGTAGCTGCC_3	CD4+ T
TGGGTTACAGTAACGG_3	CD8+ T
ATGGTTGAGCAATAGT_3	CD8+ T
CCACTTGGTATACCTG_3	Follicular B
GGCGTCAAGTCAACAA_3	CD8+ T
ATGCATGAGCTGGTGA_3	NK
TTGACCCGTGTTCCTC_3	Mac
TCTGGCTAGCTCGTGC_3	CD8+ T
GGAGGATCATACCATG_3	Mac
ATCGGCGCACAAATGA_3	Follicular B
TTCAATCCAGAGAAAG_3	NK
TCCACCACACGGAAGT_3	CD4+ T
CATCGGGGTCTAGATC_3	CD8+ T
CTCCAACAGTATGGCG_3	CD8+ T
GGATGTTGTTGCGAAG_3	CD4+ T
CATCGTCAGGCTCTCG_3	NK
GTATTGGCAGCCGGTT_3	Follicular B
GTAGAGGAGGTTGACG_3	CD8+ T
CTCGAGGTCTCCGCAT_3	Follicular B
CTCTCAGAGGTTGTTC_3	NK
TCGGTCTGTGTGAATA_3	NK
ATTATCCTCATCGGGC_3	NK
AGCCACGCATGGAATA_3	Follicular B
TATACCTTCGCACGGT_3	Mac
AGTCTCCTCATGCAGT_3	Mac
TCCTCGAGTCTGCATA_3	EC
ACTTTCAGTCGTTCAA_3	NK
GCATCGGAGAACTCCT_3	CD8+ T
CCGATGGGTTAGGCTT_3	Follicular B
AAAGTGACAATCCAGT_3	CD8+ T
AACGTCAGTACTCAAC_3	NK
ACTATGGTCTGAGCAT_3	NK
AGAGAGCTCGGCTCTT_3	Follicular B
AATGGCTAGCAGGCAT_3	CD4+ T
GTGTGGCAGCGTGTCC_3	CD4+ T
AGTTCCCCAAGCGCTC_3	Follicular B
TCGAAGTGTATACAGA_3	NK
CACAACAAGTGTTGAA_3	CD4+ T
CGGGTGTTCAACCGAT_3	Monocyte
CCTCCAATCTTGCAAG_3	Mac
GAGTCATCACTTCAAG_3	Follicular B
ACTGATGCAATGTCAC_3	CD8+ T
AATGGCTCACAGCCTG_3	Follicular B
GCTCAAAAGAGCCTGA_3	NK
TCGGGTGGTAAGTTAG_3	Monocyte
CATTCATTCTCTCCGA_3	EC
TCGACGGTCATCGCTC_3	NK
TCACTCGCATATGAAG_3	Mac
GGGAAGTTCACTTGGA_3	Follicular B
GATCGTAAGTGTACCT_3	CD4+ T
ACAAAGAAGCAAGTGC_3	Mac
CGAGTGCGTGTCTTAG_3	EC
CATAGACCAGCACAAG_3	CD8+ T
ACGTACACACCTGCGA_3	NK
GGAGGATAGTCCCGGT_3	CD4+ T
TCCTTTCCAATGGCAG_3	NK
AGTCTCCGTAGCGTAG_3	Follicular B
CAGATCAGTGCTGCAC_3	CD8+ T
TCCTCGAGTAGGTAGC_3	CD8+ T
CTAGGTAGTTAGTTCG_3	CD8+ T
GTAGATCGTCCAAGAG_3	Monocyte
ACGCACGCATCGAAGG_3	CD4+ T
GGGCCATGTGTCTAAC_3	CD4+ T
TGGAACTAGAGGGTCT_3	CD8+ T
TCACTCGAGACCGCCT_3	CD8+ T
AGTCTCCGTTGAATCC_3	NK
GTAGGTTTCTGCTTAT_3	CD8+ T
TGCAGGCGTCGCAGTC_3	CD8+ T
TCGACCTAGCTGTTCA_3	CD8+ T
CTGCAGGTCTGGCCTT_3	MZ B
GACTCAACATACCACA_3	CD8+ T
TTGAGTGAGATGGCGT_3	Monocyte
TCATGAGGTGTCCTAA_3	CD8+ T
GATAGAATCCATCTAT_3	NK
TGCAGTACAAAGACTA_3	Mac
CCGGTAGTCTCTATAC_3	Monocyte
GCGTTTCGTTCTGACA_3	CD8+ T
GGGCTCACATCCTAAG_3	DC2
ATGAAAGCAGGCGATA_3	CD8+ T
CGCATGGGTCCGATCG_3	Monocyte
CACAGATGTACCACGC_3	CD8+ T
AACCTGAAGGTGAGCT_3	NK
TTGAGTGCACAACCGC_3	NK
CCTCTCCAGGATCACG_3	CD4+ T
TGCAGGCGTAGCTCGC_3	CD8+ T
GTTACGAGTCGCATCG_3	NK
AAGCATCAGCGCCATC_3	NK
AGTTCCCCAATTGCTG_3	CD8+ T
AACAAGAGTCGGAACA_3	NK
TCTTCCTCATTGTAGC_3	Follicular B
CAGGTATAGGGACACT_3	CD8+ T
TATCGCCTCTTACGGA_3	CD8+ T
AATGAAGCACCTGCTT_3	Follicular B
GGCTTTCAGACATCCT_3	NK
ATGCCTCCATTATGCG_3	CD4+ T
CCGTGAGTCTATCGTT_3	Follicular B
AGTACTGGTGACAGCA_3	CD8+ T
ATGGGAGAGATGCTTC_3	CD8+ T
TGATTTCGTCCTATAG_3	CD4+ T
TGTTTGTAGATTCGCT_3	Follicular B
CGGAGAAAGATCCCAT_3	NK
GGAGATGGTTGGTACT_3	CD8+ T
ACTTCCGGTCAGTCTA_3	CD8+ T
TACGGGCAGCACTCGC_3	CD8+ T
CATACTTAGGATACCG_3	CD8+ T
CACCAAATCCATACTT_3	NK
CTTGAGATCACCGGTG_3	CD8+ T
TTGGGATTCCCAAGTA_3	CD8+ T
GCATTAGCAGGCACTC_3	Plasma cell
ATGGAGGTCGAACCTA_3	NK
ACATTTCGTCTGTGGC_3	CD8+ T
AAGCCATCAGCGTTGC_3	CD4+ T
TGTCCACTCCACAGGC_3	NK
GGGTCTGTCCCGAGTG_3	CD8+ T
AGACACTGTGTAGGAC_3	NK
CAACGGCAGAGGCGGA_3	Mac
TTGGATGGTCCCGTGA_3	Follicular B
TAACACGCAAAGCAAT_3	CD4+ T
CGTGAATCAGCTATTG_3	CD4+ T
TATTCCAGTAGCGCCT_3	CD4+ T
CCACGTTCACGACAAG_3	CD8+ T
CTCCCTCCAGTCAACT_3	NK
CCAAGCGGTCGGTAAG_3	CD8+ T
AGCCACGCACAGTGAG_3	NK
CTACATTTCAAGTGTC_3	Monocyte
CTCAACCAGTTGGAAT_3	CD8+ T
TCATGAGCAAGGCGTA_3	Follicular B
CCCGGAAAGCGAACTG_3	ILC
AAAGAACCAGTTACCA_3	MZ B
GTGAGGATCGAACTCA_3	NK
TTCGCTGTCGCAATTG_3	NK
GGTCTGGGTGGACTAG_3	CD8+ T
TCGCTCACATGACAAA_3	CD8+ T
TCCGTGTTCCTAACAG_3	CD4+ T
TGCTCGTTCAATCCAG_3	CD8+ T
GGGATGATCGTGTGGC_3	MZ B
CACTAAGAGTTCGGTT_3	CD4+ T
CACTTCGGTTTGCCGG_3	DC2
ACGGTCGGTGAATTGA_3	CD8+ T
TACCCGTCAGTCAGAG_3	CD8+ T
TATTGCTTCGATTTCT_3	CD8+ T
GCGAGAATCCTTATGT_3	NK
GTCGCGAAGATCCAAA_3	Follicular B
CTACGGGCATCTTTCA_3	NK
GTGGCGTGTGTTAGCT_3	Ery
TCGTGGGGTAGCGATG_3	Follicular B
GGCTTTCAGTAGTCAA_3	Mac
GGTAATCGTTTCGATG_3	CD4+ T
AGGAATAAGAAACCCG_3	CD8+ T
TCGCTCAGTTATAGAG_3	NK
GCTTCACGTTCAGCGC_3	CD8+ T
CCTTTGGCATTGCTTT_3	CD4+ T
TGCAGGCGTCGGTGTC_3	Fibroblast
TGTAGACTCTTTGGAG_3	NK
GACCGTGGTGGAACCA_3	Follicular B
ATACTTCTCAGAGTTC_3	MZ B
TTCTAGTAGAGTTGTA_3	CD4+ T
TCCATGCAGCTACTAC_3	Mac
GATGAGGAGTCGTCTA_3	CD8+ T
GACTATGGTGGGTATG_3	ILC
TTGCCTGGTAAGATCA_3	CD4+ T
CACAGGCTCGGACCAC_3	CD8+ T
AGAAGTATCGGAGTGA_3	NK
TGCGGCAGTCACTCGG_3	CD8+ T
GGATCTACAGTGCCTG_3	Monocyte
TTCCGGTAGCGTACAG_3	NK
AACACACGTAGCACAG_3	NK
TGGCGTGTCTGACCCT_3	CD8+ T
ATCGTCCGTAGGATAT_3	NK
TGCAGGCGTTCAAGTC_3	Follicular B
GGGATGACACTGTGTA_3	CD8+ T
ATGCGATCAGGCAATG_3	CD8+ T
AAAGGGCTCCCGAGAC_3	NK
CCTAACCAGATTGAGT_3	NK
AAGAACATCGCTAGCG_3	Monocyte
ATTCAGGAGTAACCTC_3	CD8+ T
ACAACCATCGTGAGAG_3	Follicular B
GACCTTCCAGGCGATA_3	EC
GACCGTGTCTACCTTA_3	CD8+ T
GGGATCCCAGATGCGA_3	Mac
TCGGTCTTCTTGGCTC_3	Mac
CCCTTAGTCGATTGGT_3	CD8+ T
TGTGAGTCAGGATGAC_3	Follicular B
TCCTGCAGTAACGATA_3	Monocyte
CCACCATCAAGCAGGT_3	CD8+ T
AACCTTTGTTAGAGAT_3	Follicular B
ATTATCCGTGGATGAC_3	Mac
GCTGAATCATAGAAAC_3	Mac
CGAGGAAAGTGGGAAA_3	CD8+ T
GAGACTTCACATCATG_3	Mac
GTAATGCTCCCGAAAT_3	NK
GCATTAGAGTTTCAGC_3	CD8+ T
CATGAGTTCGGAACTT_3	CD4+ T
TTTACTGGTAATCAGA_3	Follicular B
GTCTAGAAGTACAGCG_3	NK
TCCAGAAAGTTGGAGC_3	CD8+ T
AGCCAATTCCTGCCAT_3	NK
TTTGACTTCGGTTGTA_3	CD8+ T
CAACGATGTTACTCAG_3	NK
TGCTGAACACTAGGCC_3	CD8+ T
TCATTACGTGCGACAA_3	Monocyte
GATTTCTAGCGACATG_3	Mac
TCCATGCTCGCCTTTG_3	Follicular B
CCAAGCGAGTTGCCTA_3	NK
TGTAACGAGAGCATAT_3	CD8+ T
TGGGTTAGTTCGGCGT_3	NK
GCCAGCAGTCGTACTA_3	Follicular B
CCGTGAGCACTTGGCG_3	ILC
CTTCCGAGTAGTGCGA_3	Follicular B
TGCAGTAGTCCTACAA_3	Ery
GCCAACGAGGTCTTTG_3	Follicular B
TCAGTGAAGAGCCCAA_3	MZ B
AAGCGTTCAATGTCTG_3	Ery
GGGTCACAGGCTTCCG_3	NK
CACAACATCTTTGATC_3	Follicular B
TCATATCGTCGAGTGA_3	Follicular B
CTTCCTTAGTCCCTAA_3	Plasma cell
ACTTCCGCATAAGATG_3	MZ B
CAGCACGTCCCAACTC_3	Mac
TTTCGATCATAACGGG_3	Monocyte
CCTCACAAGCCTCTCT_3	Monocyte
ACACTGAGTCTTGAGT_3	NK
GTTCCGTAGTGGCGAT_3	Follicular B
AGTCATGTCACGTCCT_3	Follicular B
TGTTGGAAGGGTTAAT_3	EC
TAGACCAGTAGGAAAG_3	NK
ATCGGCGTCAACGCTA_3	CD8+ T
TGGAGGAAGTGGACTG_3	CD8+ T
GGAGCAATCATCACCC_3	Mac
CAGGCCACAGTCGCAC_3	Mac
ATTGGGTCAGGCCTGT_3	CD8+ T
CACAGATAGCGGGTAT_3	CD8+ T
ATCATTCCAGACCTGC_3	Monocyte
TCCTAATAGCGGATCA_3	NK
ATCGTGAGTCTAGGTT_3	Follicular B
GTGCACGTCCCTTGGT_3	Monocyte
GTTCGCTTCCTTTAGT_3	Follicular B
CTCAGTCGTCACAATC_3	CD4+ T
AAGCGTTCAGACCAAG_3	CD8+ T
AGTGACTCAATAGGGC_3	CD8+ T
TCGCTCATCTAGTGTG_3	CD8+ T
ACGGTCGTCATCGCCT_3	CD4+ T
TCGACCTGTCCGCAGT_3	Monocyte
TCAGTGAGTTGAGTCT_3	CD8+ T
AGCGATTCAAGTATAG_3	Follicular B
TTTGATCGTAATCAAG_3	EC
GGAACCCCAAGAGTTA_3	Follicular B
TTCCTAACATGACGAG_3	Mac
CCTTCAGAGACCACGA_3	Ery
GATGATCTCGACATAC_3	CD4+ T
CGATCGGAGGGCTTCC_3	CD8+ T
AAGTCGTGTGGTCCGT_3	Monocyte
GTTGAACGTTGATCGT_3	CD8+ T
AAACGAACACTTGAAC_3	Mac
TCATTCAAGTCATGGG_3	Mac
AGAGCAGAGATGGCGT_3	Mac
AAAGTCCCATTGACTG_3	CD8+ T
TATCTGTAGGTACATA_3	NK
CTGTCGTCATCCTTGC_3	CD8+ T
GCGTTTCTCTCGACGG_3	NK
AATCGACCATAGGTTC_3	Follicular B
GATGACTTCGCTGTCT_3	Mac
TCACACCCACGCTGTG_3	Follicular B
ATCACGATCGATGGAG_3	CD8+ T
TTACCATTCTCGAACA_3	Plasma cell
TGTGAGTGTGAGTTTC_3	Follicular B
AGGTTGTGTGAGTAAT_3	NK
TACCTGCTCTGGGCGT_3	CD8+ T
TTTCACAAGGCTCAAG_3	CD8+ T
CAATGACTCGAGATGG_3	CD8+ T
GTGAGCCCACAAGCTT_3	CD8+ T
TCAAGTGAGTAGATCA_3	CD4+ T
AAGAACAGTACCGCGT_3	Mac
TTCTTGAAGTCGGGAT_3	CD8+ T
TCGTCCAGTACACGTT_3	CD8+ T
TCCTGCAGTGAGCAGT_3	CD8+ T
TTACGCCGTGCTAGCC_3	ILC
TCAAGTGAGGAACGAA_3	CD4+ T
CCTAAGAGTTAACCTG_3	Monocyte
TGTTTGTAGGGAGGCA_3	CD4+ T
GAGAAATGTGTTCCAA_3	Follicular B
GGCAGTCTCCTAAACG_3	Monocyte
TTGCGTCGTTCTCCCA_3	Monocyte
CTACGGGCATCCTATT_3	Mac
TGAATCGAGAATCCCT_3	Mac
CAATTTCCAGCTTCCT_3	Mac
GTCATCCAGCGTATGG_3	CD8+ T
TACGTCCAGTAGTCAA_3	NK
CGTGAATGTTCAGCTA_3	NK
AGCGCCAGTGTTAAAG_3	CD8+ T
GTCTACCTCCATGCAA_3	Mac
CTGTATTAGTTGTAAG_3	Mac
CTCAAGAAGCGACTAG_3	NK
AGTTCGATCCGCACTT_3	CD4+ T
AGTAGTCAGGTACAAT_3	MZ B
TTTGTTGCAAAGCTCT_3	NK
TATGTTCAGTCATAGA_3	NK
AGCCACGAGTAGGAAG_3	MZ B
ATCATTCCACGGGTAA_3	Mac
CTCAGAACAATAAGGT_3	Mac
GCCAACGGTATCGAAA_3	CD4+ T
CACTAAGTCGAAGTGG_3	Follicular B
CCGGACAAGTCTGGAG_3	CD4+ T
AGTGCCGAGTCCTGTA_3	NK
GGGAGTACATGGGTTT_3	Mac
TCCCATGAGGACAAGA_3	Mac
CAGATCATCGTCCTTG_3	Mac
GTGCTGGTCCAGCCTT_3	NK
GGTTCTCGTGATGTAA_3	NK
GTGACGCAGATACCAA_3	CD4+ T
GTCATCCTCCCTTCCC_3	Mac
TGATCAGTCTGCCTGT_3	Mac
TCGCAGGTCGACCATA_3	Monocyte
ACAAGCTGTGTGTGTT_3	CD8+ T
CTTTCGGTCCGTAGGC_3	Follicular B
AGACACTTCATTTCCA_3	Follicular B
GTCATTTCAAGACTGG_3	Mac
GCAGGCTGTCCCGGTA_3	CD8+ T
CATGCGGCAAATAAGC_3	NK
GTAGGTTAGGGAGGGT_3	NK
TACCTGCTCGAGATGG_3	Mac
GTTGTGATCGGAAGGT_3	Mac
CAGGCCAAGCACGGAT_3	Mac
ATTCGTTGTGGTTCTA_3	NK
GTGGCGTTCTGACGCG_3	MZ B
GTTATGGGTCACTAGT_3	NK
TTTCGATTCATGCGGC_3	Follicular B
CCCGAAGCACTGCTTC_3	CD4+ T
TCGCAGGTCACCTGTC_3	Monocyte
TCGTGCTCACAAGTTC_3	CD8+ T
GGGTGAATCTGGGAGA_3	CD8+ T
AAATGGAGTGGTTTAC_3	CD4+ T
TCTCAGCCAGGACATG_3	EC
ACACGCGCAGGTATGG_3	Mac
CATGGATGTATAGGGC_3	DC1
GGGAGTATCTTCGCTG_3	CD4+ T
GTGGGAACACACGGAA_3	Monocyte
CCCTTAGGTGAACTAA_3	ILC
ACCGTTCGTTGAGTCT_3	CD8+ T
GACTATGCATGGAAGC_3	Mac
GTCACGGCAGGTGTGA_3	CD8+ T
CATGCGGGTATACCCA_3	CD8+ T
CCTGCATGTATGCGTT_3	Follicular B
AGAGCCCTCAGTGCGC_3	Mac
GCGGAAAAGTAATCCC_3	Mac
CCCTAACCAGTTAAAG_3	Monocyte
GTGAGCCTCGGTTCAA_3	MZ B
TAAGCACAGTGTGTTC_3	Mac
ATTCACTCAGGTGAGT_3	CD4+ T
TCACAAGGTAGCTTGT_3	Monocyte
TTTCATGCACACCTTC_3	Mac
CTGTCGTAGTCATGAA_3	Mac
AAGGTAAAGGCATTTC_3	Mac
TGTAAGCTCGAGCACC_3	Monocyte
GGAGAACGTAGAATGT_3	Mac
CGGGTGTCAGTGGCTC_3	CD8+ T
CAATGACCAAACGTGG_3	Mac
GACCTTCTCAGACAAA_3	EC
AGCAGTGGTATCAACG_3	Follicular B
GGTTCTCAGGAACATT_3	Monocyte
TAGCACATCAGCTGTA_3	Mac
TCCTCGACATGATAGA_3	CD4+ T
GACCTTCAGAAGAGCA_3	CD8+ T
CGAAGTTCAGAGTCAG_3	Mac
GGGATCCGTTTCCCAC_3	Mac
TGCGACGTCCCATAAG_3	CD8+ T
TTTGACTGTATTAAGG_3	Monocyte
GGTAACTTCCGAGTGC_3	CD4+ T
GATTTCTGTGTAAATG_3	NK
CCATCACGTCAATCTG_3	Monocyte
TAGAGTCCAATGGGTG_3	Mac
AGAGCAGGTGCGTCGT_3	CD8+ T
CAGCCAGTCATGCGGC_3	Monocyte
GGTGTTACAGCTGCCA_3	Mac
GCGTGCACATGAGTAA_3	Follicular B
TCAAGACGTTTGACAC_3	Mac
CAACAACCAAGGACAC_3	Mac
TACGGTACAATGCAAA_3	Mac
TTGATGGAGTGTTGTC_3	NK
ACCAAACTCCATCACC_3	Monocyte
GACCCTTCAGAAATCA_3	Mac
TGTAACGCAGTTGAAA_3	CD4+ T
CTGGTCTGTGGTCCCA_3	Monocyte
CGCCAGATCCATTTAC_3	Mac
CGTAATGGTCCAAAGG_3	Mac
TTTGACTCATGGGCAA_3	Follicular B
TGTAAGCGTAGTTAGA_3	CD8+ T
CCAATTTAGTGACACG_3	Mac
CCCGGAACACACTTAG_3	Mac
CGATCGGTCTGAGATC_3	Mac
TCAAGACAGGTCGACA_3	EC
GATGGAGAGGTGCTAG_3	Follicular B
CTGTGAATCCTAGCGG_3	Mac
AACCACATCTGAGGTT_3	Ery
AACTTCTGTTACGGAG_3	Mac
TAAGCACGTACGTGAG_3	CD8+ T
TAAGCACAGACGTCCC_3	Mac
AGAGCAGGTCTCAGGC_3	Mac
GAAACCTCATGAGGGT_3	CD8+ T
CATCAAGCACTTGACA_3	Mac
GCCAGTGGTCGGTGTC_3	CD4+ T
GTGGAGACAGGAAGTC_3	Mac
AGACAAACACAGTACT_3	Mac
TCCACCAGTTCTCCCA_3	Mac
CTCAGTCAGCGTGAGT_3	Mac
AGTGTTGAGGACGCAT_3	Mac
CCTAACCGTCCTGGGT_3	Mac
GCTTCACAGGATATAC_3	CD8+ T
TAGAGTCAGATAGCAT_3	Monocyte
TGTTCCGTCGATGGAG_3	Mac
GCAACATGTGGAACCA_3	Mac
TACACCCCACGCCAGT_3	Mac
TCCCACATCTGGCTGG_3	Mac
GCAGGCTCATACTGAC_3	Mac
TGACGCGCACCAGCCA_3	Mac
GTGTGGCAGTGCTCGC_3	Mac
CCTCATGCAAGAAACT_3	Mac
CTGTAGACAGGTTACT_3	Mac
AGAAGTAAGCCTGTCG_3	Mac
CGATGGCCACTGGACC_3	Mac
AGGTAGGGTAACACGG_3	Mac
GTCTGTCGTTACGGAG_3	Mac
GGTAACTAGTCATAGA_3	Mac
GACAGCCCACTTGTCC_3	Mac
ACTGTCCGTTTCCCAC_3	Mac
AGACTCAAGCACTTTG_3	Mac
GCCATTCTCCCATTTA_3	Mac
TCTCAGCAGTACGTCT_3	Mac
CCGATGGAGACTGTTC_3	Mac
AGACCCGCAGCGTACC_3	Mac
GGGTGTCTCAGGACAG_3	Monocyte
TGCCGAGGTGTTGACT_3	Mac
CAATACGGTTAAACAG_3	Mac
CGTGATACATAGTCGT_3	Mac
TCATGCCAGATTGAGT_3	EC
TGTACAGAGGAACGAA_3	Mac
CACGAATTCAAATGCC_3	Mac
CCTTTGGAGCACACAG_3	Mac
GTCACGGCATCCCACT_3	Mac
TCGACGGCATCAGCAT_3	Mac
TCGGTCTCAAGAGTAT_3	EC
TATTGCTAGCTCTGTA_3	Mac
CCCGAAGTCTAGCCTC_3	Mac
CCTATCGGTAGGTACG_3	Mac
ACGGAAGTCCTAAGTG_3	Mac
CGAGTGCCATCCGAAT_3	Mac
CCGGTGAAGAAGATCT_3	Mac
CTTTCGGTCCTACACC_3	Mac
TTCGATTCAATGAACA_3	Mac
TAGAGTCAGCTTAAGA_3	Monocyte
AAACGCTGTGAGTGAC_3	Mac
ATTCATCAGGTTCACT_3	Mac
AGGTCATTCTCTGACC_3	Mac
ACGTAGTGTCTAACGT_3	Mac
TGAATCGCATGTAACC_3	Mac
TTATTGCGTTGTTTGG_3	Mac
CAGCGTGCAAAGGAGA_3	Mac
ACATCGATCAACCGAT_3	EC
GGTAGAGCAAGCCTGC_3	Mac
TGCAGTACAAATGATG_3	Mac
AATCACGAGCACTCGC_3	Mac
GAAGCGACACTCCTGT_3	Mac
GTAGGTTCAGATGCGA_3	Mac
GCACTAAGTAGCGATG_3	Mac
